possession_id,start_frame,end_frame,duration_frames,avg_spread,duration_sec
0,2755,2755,0,322.09002265447396,0.0
1,2811,2815,4,565.5815653739327,0.13333333333333333
2,2816,2816,0,217.06846641747006,0.0
3,2817,2818,1,353.84816369219595,0.03333333333333333
4,2819,2819,0,61.71440190285174,0.0
5,2820,2820,0,295.28710901534794,0.0
6,2828,2829,1,144.67697586640287,0.03333333333333333
7,2839,2839,0,325.69448746653734,0.0
8,2841,2841,0,455.9560746691513,0.0
9,2842,2843,1,59.32866966042136,0.03333333333333333
10,2844,2844,0,254.26728923404153,0.0
11,2845,2846,1,53.840106711905264,0.03333333333333333
12,2854,2854,0,181.09752815222873,0.0
13,2856,2857,1,346.0736510232646,0.03333333333333333
14,2858,2858,0,76.0117762454245,0.0
15,2859,2859,0,239.13420736548423,0.0
16,2860,2860,0,458.0668005126884,0.0
17,2861,2873,12,246.8626849921412,0.4
18,2874,2875,1,100.09816927712706,0.03333333333333333
19,2876,2879,3,264.04359079752044,0.1
20,2880,2880,0,83.50060304540706,0.0
21,2881,2882,1,285.34521098001915,0.03333333333333333
22,2889,2889,0,523.8954603266615,0.0
23,2910,2910,0,413.8891927687458,0.0
24,2919,2919,0,171.16443172175474,0.0
25,2923,2923,0,342.95150803296934,0.0
26,2924,2925,1,180.00255396203713,0.03333333333333333
27,2926,2928,2,402.1591934898083,0.06666666666666667
28,2934,2939,5,166.34940867123117,0.16666666666666666
29,2967,2971,4,414.0362834155599,0.13333333333333333
30,2975,2975,0,629.8371239624983,0.0
31,2991,2991,0,337.70106712839276,0.0
32,2996,2997,1,89.90603361061528,0.03333333333333333
33,3008,3054,46,288.3530737499286,1.5333333333333334
34,3056,3058,2,317.5970576794582,0.06666666666666667
35,3059,3059,0,505.62418867178394,0.0
36,3072,3072,0,181.13012019713082,0.0
37,3073,3074,1,335.4610664842812,0.03333333333333333
38,3076,3080,4,204.7088611030693,0.13333333333333333
39,3081,3083,2,269.9642334821813,0.06666666666666667
40,3087,3088,1,432.42567887737556,0.03333333333333333
41,3091,3091,0,346.3892230304723,0.0
42,3092,3092,0,452.8714600999274,0.0
43,3094,3095,1,304.0729392604985,0.03333333333333333
44,3097,3097,0,99.96309619915091,0.0
45,3098,3099,1,257.9878992488471,0.03333333333333333
46,3100,3106,6,326.59376268253374,0.2
47,3107,3109,2,410.26474493986615,0.06666666666666667
48,3110,3110,0,568.3340161398962,0.0
49,3111,3115,4,443.56261305273966,0.13333333333333333
50,3117,3117,0,134.84977204914276,0.0
51,3121,3122,1,269.51801319480376,0.03333333333333333
52,3123,3123,0,440.22882649572125,0.0
53,3127,3129,2,104.43039473839337,0.06666666666666667
54,3130,3130,0,274.8465012410695,0.0
55,3131,3139,8,279.35910094492044,0.26666666666666666
56,3140,3144,4,116.9232604015735,0.13333333333333333
57,3145,3145,0,505.27694450571266,0.0
58,3158,3164,6,596.4114093105555,0.2
59,3165,3165,0,336.70456735588937,0.0
60,3172,3172,0,687.4815480651674,0.0
61,3173,3173,0,563.4826205847779,0.0
62,3178,3183,5,225.05351918676982,0.16666666666666666
63,3186,3187,1,411.8509228046524,0.03333333333333333
64,3188,3190,2,505.0975307172198,0.06666666666666667
65,3191,3199,8,490.4084749063591,0.26666666666666666
66,3200,3204,4,477.6540265579969,0.13333333333333333
67,3205,3205,0,227.27204313757778,0.0
68,3206,3207,1,417.66592559332264,0.03333333333333333
69,3208,3209,1,592.8230488982724,0.03333333333333333
70,3210,3216,6,428.8390404338882,0.2
71,3217,3230,13,301.28455447024174,0.43333333333333335
72,3231,3233,2,489.961475091339,0.06666666666666667
73,3234,3238,4,423.2141293189319,0.13333333333333333
74,3239,3239,0,656.0761552145163,0.0
75,3240,3240,0,202.29364008139817,0.0
76,3241,3242,1,365.20332811151263,0.03333333333333333
77,3243,3244,1,248.0803638106065,0.03333333333333333
78,3245,3246,1,473.05599244012075,0.03333333333333333
79,3247,3248,1,281.44733634062237,0.03333333333333333
80,3249,3249,0,433.2633817445248,0.0
81,3250,3252,2,316.5588524251512,0.06666666666666667
82,3253,3254,1,614.9904929341637,0.03333333333333333
83,3255,3257,2,307.3397045659755,0.06666666666666667
84,3258,3258,0,208.2056887350628,0.0
85,3259,3259,0,482.77212140685583,0.0
86,3260,3261,1,369.77660229451203,0.03333333333333333
87,3263,3266,3,245.8038268935298,0.1
88,3267,3270,3,263.77064819308873,0.1
89,3271,3271,0,403.0714819956146,0.0
90,3272,3285,13,254.65367224227822,0.43333333333333335
91,3286,3290,4,427.0795324071606,0.13333333333333333
92,3291,3291,0,512.5698845435633,0.0
93,3293,3294,1,587.2772173454553,0.03333333333333333
94,3297,3304,7,275.54140298859903,0.23333333333333334
95,3305,3307,2,241.5089956077958,0.06666666666666667
96,3308,3313,5,350.7792606781746,0.16666666666666666
97,3314,3314,0,446.25166910718684,0.0
98,3315,3328,13,283.47389005876863,0.43333333333333335
99,3329,3329,0,64.29350602499001,0.0
100,3330,3330,0,199.99398123213874,0.0
101,3331,3332,1,380.78721053287325,0.03333333333333333
102,3333,3333,0,266.3883737444829,0.0
103,3334,3334,0,412.172765326876,0.0
104,3335,3338,3,293.39898977767905,0.1
105,3339,3340,1,252.4800194459328,0.03333333333333333
106,3341,3341,0,359.3559389135781,0.0
107,3342,3345,3,140.7664280787932,0.1
108,3346,3347,1,214.2453837781444,0.03333333333333333
109,3348,3349,1,309.3086923338283,0.03333333333333333
110,3350,3350,0,208.1165919038714,0.0
111,3351,3355,4,386.6933449285872,0.13333333333333333
112,3356,3362,6,367.61159532277327,0.2
113,3363,3363,0,473.6508550536925,0.0
114,3364,3365,1,139.20842939920323,0.03333333333333333
115,3366,3368,2,495.0030208858402,0.06666666666666667
116,3369,3371,2,372.1555223007667,0.06666666666666667
117,3372,3373,1,130.8006254367271,0.03333333333333333
118,3375,3376,1,477.31280773789564,0.03333333333333333
119,3377,3377,0,351.57067582956995,0.0
120,3378,3380,2,458.9063161348284,0.06666666666666667
121,3386,3387,1,79.5563306635444,0.03333333333333333
122,3388,3388,0,485.8438024334573,0.0
123,3389,3390,1,93.70277162933388,0.03333333333333333
124,3391,3393,2,519.4067361598176,0.06666666666666667
125,3395,3397,2,111.50396379320195,0.06666666666666667
126,3399,3399,0,518.148812312315,0.0
127,3401,3404,3,140.50534682934511,0.1
128,3405,3407,2,480.9084292769981,0.06666666666666667
129,3408,3408,0,91.1637871666531,0.0
130,3409,3411,2,661.3105667374834,0.06666666666666667
131,3413,3415,2,415.46142519121616,0.06666666666666667
132,3417,3417,0,199.71236683004577,0.0
133,3418,3418,0,684.7306228307449,0.0
134,3419,3423,4,195.1197027958561,0.13333333333333333
135,3425,3437,12,305.6100782891521,0.4
136,3438,3441,3,272.3349330891356,0.1
137,3442,3445,3,227.7052271093566,0.1
138,3446,3446,0,109.69711850361573,0.0
139,3447,3463,16,261.64350128779273,0.5333333333333333
140,3464,3465,1,366.0573273492659,0.03333333333333333
141,3466,3470,4,205.06324794902199,0.13333333333333333
142,3471,3471,0,97.59589959297415,0.0
143,3472,3476,4,238.37343271456126,0.13333333333333333
144,3477,3488,11,249.4411842280529,0.36666666666666664
145,3489,3492,3,322.79169281276734,0.1
146,3493,3523,30,298.3343809493856,1.0
147,3524,3551,27,339.19569747138956,0.9
148,3552,3564,12,294.96699055592364,0.4
149,3565,3567,2,400.2327476477667,0.06666666666666667
150,3568,3594,26,290.59558403381476,0.8666666666666667
151,3595,3595,0,151.1596711813516,0.0
152,3596,3636,40,297.088273498325,1.3333333333333333
153,3637,3658,21,359.44379567098053,0.7
154,3659,3660,1,261.3510548612495,0.03333333333333333
155,3661,3665,4,336.36391979675426,0.13333333333333333
156,3666,3668,2,408.5328503011859,0.06666666666666667
157,3670,3670,0,168.98113300165596,0.0
158,3671,3694,23,442.06706929399684,0.7666666666666667
159,3695,3697,2,556.2854861544516,0.06666666666666667
160,3698,3714,16,422.7459216242916,0.5333333333333333
161,3715,3718,3,538.3276172329248,0.1
162,3719,3722,3,326.7279692605463,0.1
163,3723,3723,0,198.55011046556822,0.0
164,3724,3724,0,341.0921603514897,0.0
165,3725,3726,1,215.68246453578183,0.03333333333333333
166,3727,3766,39,453.2725807910054,1.3
167,3767,3768,1,504.8685858196576,0.03333333333333333
168,3769,3790,21,473.8602851248819,0.7
169,3791,3791,0,556.3414463095903,0.0
170,3792,3792,0,413.81805509878296,0.0
171,3793,3798,5,528.4265355428216,0.16666666666666666
172,3799,3801,2,440.60097909829483,0.06666666666666667
173,3802,3802,0,212.07155930059844,0.0
174,3803,3829,26,567.7385822527168,0.8666666666666667
175,3830,3860,30,522.7472729853469,1.0
176,3861,3881,20,460.005664398705,0.6666666666666666
177,3882,3883,1,327.409294192998,0.03333333333333333
178,3884,3884,0,511.3853536281481,0.0
179,3885,3888,3,372.1078943748521,0.1
180,3889,3890,1,498.999777449005,0.03333333333333333
181,3891,3892,1,150.80021878310842,0.03333333333333333
182,3893,3893,0,663.8367201605928,0.0
183,3894,3894,0,523.4641918382865,0.0
184,3895,3895,0,347.94729198942974,0.0
185,3896,3907,11,426.75856489200174,0.36666666666666664
186,3908,3908,0,651.5319374537876,0.0
187,3909,3909,0,499.2197898164421,0.0
188,3910,3926,16,430.83138544841,0.5333333333333333
189,3927,3929,2,366.05377108741897,0.06666666666666667
190,3930,3940,10,281.79967563515055,0.3333333333333333
191,3941,3976,35,407.574082010325,1.1666666666666667
192,3977,3987,10,431.9247113011779,0.3333333333333333
193,3988,3988,0,541.292210985655,0.0
194,3989,3996,7,389.19139748769993,0.23333333333333334
195,3997,3997,0,263.4537586941492,0.0
196,3998,4003,5,409.1564054120422,0.16666666666666666
197,4004,4008,4,434.66359274710885,0.13333333333333333
198,4009,4010,1,225.65651150626258,0.03333333333333333
199,4011,4011,0,431.58378479947504,0.0
200,4012,4012,0,285.95302071440835,0.0
201,4013,4013,0,540.849059801469,0.0
202,4014,4014,0,129.84811596171468,0.0
203,4015,4017,2,362.65723982618897,0.06666666666666667
204,4018,4024,6,400.865471503112,0.2
205,4025,4031,6,330.65198576628035,0.2
206,4032,4032,0,341.8688357396471,0.0
207,4033,4033,0,483.9695534377488,0.0
208,4034,4034,0,269.40261907124244,0.0
209,4035,4035,0,510.7208644626843,0.0
210,4036,4037,1,359.7984176784159,0.03333333333333333
211,4038,4045,7,525.9127108691159,0.23333333333333334
212,4046,4074,28,426.00302496505526,0.9333333333333333
213,4075,4078,3,555.6491638632574,0.1
214,4079,4080,1,407.65051302861696,0.03333333333333333
215,4081,4084,3,562.0190474850427,0.1
216,4085,4085,0,476.4209519678763,0.0
217,4086,4086,0,637.3734399863962,0.0
218,4087,4087,0,234.63013483116163,0.0
219,4088,4091,3,568.9934719779927,0.1
220,4092,4098,6,477.5021778933657,0.2
221,4099,4102,3,471.9773460915423,0.1
222,4103,4105,2,659.7179498584491,0.06666666666666667
223,4106,4112,6,628.1658395705325,0.2
224,4113,4113,0,371.6970783435172,0.0
225,4114,4122,8,480.5953884451799,0.26666666666666666
226,4123,4123,0,326.7869554962434,0.0
227,4124,4124,0,212.01772442116507,0.0
228,4125,4125,0,515.520336042811,0.0
229,4126,4129,3,345.8507430700354,0.1
230,4130,4160,30,510.18662974348456,1.0
231,4161,4167,6,588.3527879984819,0.2
232,4168,4168,0,420.96164947595275,0.0
233,4169,4173,4,563.9910885987894,0.13333333333333333
234,4174,4175,1,409.8991098747507,0.03333333333333333
235,4176,4181,5,290.082919786604,0.16666666666666666
236,4182,4183,1,368.5779369390553,0.03333333333333333
237,4184,4184,0,483.88818395942656,0.0
238,4185,4186,1,289.59221776763326,0.03333333333333333
239,4187,4187,0,135.95283284213622,0.0
240,4188,4188,0,463.5740943054781,0.0
241,4189,4192,3,570.0363501486611,0.1
242,4193,4193,0,469.0212775045222,0.0
243,4194,4194,0,365.654565891537,0.0
244,4195,4196,1,466.5431173746298,0.03333333333333333
245,4197,4198,1,164.31970119280217,0.03333333333333333
246,4199,4201,2,510.63449724107295,0.06666666666666667
247,4202,4203,1,229.16736548464024,0.03333333333333333
248,4204,4204,0,467.0187804049672,0.0
249,4209,4209,0,666.022360710382,0.0
250,4210,4210,0,274.95386770432196,0.0
251,4212,4212,0,157.49796209449727,0.0
252,4213,4214,1,477.72552617462094,0.03333333333333333
253,4215,4224,9,561.6558606360941,0.3
254,4225,4227,2,550.3426173691674,0.06666666666666667
255,4228,4233,5,438.19970005423556,0.16666666666666666
256,4234,4236,2,522.7601652209827,0.06666666666666667
257,4237,4237,0,427.1934998066839,0.0
258,4238,4258,20,535.0690693272542,0.6666666666666666
259,4259,4276,17,406.9028363926375,0.5666666666666667
260,4277,4282,5,334.1641770002418,0.16666666666666666
261,4283,4286,3,461.3123972564372,0.1
262,4287,4307,20,404.41993381272965,0.6666666666666666
263,4308,4308,0,239.7266762862389,0.0
264,4309,4310,1,451.4095978248043,0.03333333333333333
265,4311,4311,0,172.74007644627352,0.0
266,4312,4313,1,316.64451561548947,0.03333333333333333
267,4314,4320,6,246.56573729464324,0.2
268,4321,4329,8,320.087665370633,0.26666666666666666
269,4330,4330,0,425.352010122147,0.0
270,4331,4344,13,198.51788900346975,0.43333333333333335
271,4345,4345,0,296.0548291646952,0.0
272,4346,4353,7,263.09078253516026,0.23333333333333334
273,4354,4359,5,418.57511193250184,0.16666666666666666
274,4360,4360,0,304.0428447431431,0.0
275,4361,4367,6,447.75164152920064,0.2
276,4368,4369,1,353.05675803042004,0.03333333333333333
277,4370,4376,6,450.1843997341163,0.2
278,4377,4382,5,188.25023195264134,0.16666666666666666
279,4383,4383,0,433.1278387627468,0.0
280,4384,4405,21,330.05918998749917,0.7
281,4407,4411,4,258.3756846434435,0.13333333333333333
282,4412,4420,8,350.95913543510073,0.26666666666666666
283,4421,4422,1,147.4210244932904,0.03333333333333333
284,4423,4442,19,344.5950223973181,0.6333333333333333
285,4443,4443,0,438.1766428006899,0.0
286,4445,4445,0,327.5514973554182,0.0
287,4446,4447,1,440.2451510506678,0.03333333333333333
288,4448,4452,4,311.1465767868947,0.13333333333333333
289,4453,4460,7,232.90887076363026,0.23333333333333334
290,4461,4466,5,380.28709972540037,0.16666666666666666
291,4467,4467,0,596.0820338985015,0.0
292,4468,4470,2,423.13839473206434,0.06666666666666667
293,4472,4475,3,520.0813900777201,0.1
294,4476,4476,0,352.7757040774431,0.0
295,4477,4477,0,499.3482195353036,0.0
296,4478,4478,0,606.352112166324,0.0
297,4479,4479,0,386.1292166203516,0.0
298,4480,4480,0,605.9951969146917,0.0
299,4482,4482,0,204.76545991343903,0.0
300,4483,4492,9,341.89449212703954,0.3
301,4502,4502,0,582.7262310150401,0.0
302,4504,4504,0,116.2502451788204,0.0
303,4505,4505,0,471.74277393200214,0.0
304,4506,4506,0,330.99843875128465,0.0
305,4507,4507,0,485.10182182248263,0.0
306,4509,4509,0,246.9609907638738,0.0
307,4510,4510,0,508.2235377656306,0.0
308,4512,4512,0,209.81483193408758,0.0
309,4513,4513,0,483.5182519335189,0.0
310,4514,4514,0,245.58110078711636,0.0
311,4515,4515,0,687.5833391805782,0.0
312,4516,4518,2,382.5709993918643,0.06666666666666667
313,4521,4521,0,737.1623185861254,0.0
314,4523,4539,16,352.3330324268504,0.5333333333333333
315,4541,4541,0,133.17195068156812,0.0
316,4543,4551,8,341.9496928228783,0.26666666666666666
317,4552,4552,0,454.80791169073314,0.0
318,4555,4558,3,243.91920497547036,0.1
319,4559,4559,0,406.95832795084107,0.0
320,4560,4566,6,274.217754561349,0.2
321,4567,4575,8,123.39865839905917,0.26666666666666666
322,4576,4577,1,292.4422313493934,0.03333333333333333
323,4578,4578,0,129.06950617033,0.0
324,4579,4579,0,290.45916951988664,0.0
325,4580,4588,8,170.21946231100506,0.26666666666666666
326,4589,4589,0,147.30180937816434,0.0
327,4590,4590,0,323.9585810739512,0.0
328,4591,4592,1,175.9150831387145,0.03333333333333333
329,4593,4596,3,292.67019672036594,0.1
330,4597,4604,7,337.6030516550409,0.23333333333333334
331,4605,4662,57,327.6795909443705,1.9
332,4663,4664,1,336.1327262971805,0.03333333333333333
333,4665,4667,2,438.13131301079693,0.06666666666666667
334,4668,4668,0,498.4977991335192,0.0
335,4669,4670,1,328.2605099828237,0.03333333333333333
336,4671,4671,0,540.4149919008981,0.0
337,4672,4672,0,339.17947343585917,0.0
338,4673,4699,26,410.13031036658583,0.8666666666666667
339,4700,4709,9,267.8421254200538,0.3
340,4710,4714,4,387.83302412484886,0.13333333333333333
341,4715,4738,23,346.4862821340691,0.7666666666666667
342,4744,4750,6,185.0148466482053,0.2
343,4751,4762,11,207.2347204330802,0.36666666666666664
344,4763,4764,1,327.4703926422141,0.03333333333333333
345,4765,4765,0,457.4256085286874,0.0
346,4766,4767,1,353.9673764255991,0.03333333333333333
347,4768,4777,9,161.12888728908757,0.3
348,4778,4791,13,351.0986222753359,0.43333333333333335
349,4796,4802,6,124.20557972446598,0.2
350,4803,4809,6,271.7474043284395,0.2
351,4810,4810,0,463.1204064950628,0.0
352,4813,4814,1,227.75375705966192,0.03333333333333333
353,4815,4831,16,357.7198997256828,0.5333333333333333
354,4832,4833,1,155.052019915647,0.03333333333333333
355,4834,4834,0,277.3396972730877,0.0
356,4836,4836,0,391.6341775608964,0.0
357,4837,4837,0,92.84848597578448,0.0
358,4839,4839,0,528.4949185888032,0.0
359,4840,4840,0,150.70766922653942,0.0
360,4841,4848,7,484.97133934074947,0.23333333333333334
361,4849,4849,0,167.7108856257623,0.0
362,4850,4854,4,444.18912579410227,0.13333333333333333
363,4855,4855,0,297.2716152990803,0.0
364,4856,4873,17,364.41768476138304,0.5666666666666667
365,4874,4874,0,231.64762537418005,0.0
366,4875,4877,2,400.5474093944431,0.06666666666666667
367,4878,4878,0,243.0575732993323,0.0
368,4879,4891,12,411.1037858977061,0.4
369,4892,4892,0,642.7777033587918,0.0
370,4893,4893,0,472.0905932855902,0.0
371,4894,4894,0,743.3300516392844,0.0
372,4895,4904,9,438.1391215245186,0.3
373,4905,4905,0,232.77917802505647,0.0
374,4906,4908,2,364.8829332173023,0.06666666666666667
375,4909,4909,0,253.69248352123498,0.0
376,4910,4910,0,528.0373536641474,0.0
377,4911,4913,2,374.3330254652108,0.06666666666666667
378,4914,4915,1,271.8245545400795,0.03333333333333333
379,4916,4917,1,422.3247592942439,0.03333333333333333
380,4918,4919,1,123.88288983390152,0.03333333333333333
381,4922,4932,10,441.4803086067366,0.3333333333333333
382,4933,4939,6,406.0652999444219,0.2
383,4940,4940,0,172.29527794138622,0.0
384,4941,4941,0,405.70614581875077,0.0
385,4942,4950,8,207.84513657132302,0.26666666666666666
386,4951,4951,0,380.2177365063094,0.0
387,4953,4957,4,233.0398064901836,0.13333333333333333
388,4958,4968,10,244.73544004441197,0.3333333333333333
389,4969,4971,2,409.91340041407466,0.06666666666666667
390,4972,4973,1,261.0626344312781,0.03333333333333333
391,4978,4978,0,168.35962643939126,0.0
392,4979,4980,1,396.9271734047379,0.03333333333333333
393,4981,4981,0,161.56112154351555,0.0
394,4983,4984,1,298.6430171203031,0.03333333333333333
395,4989,4992,3,688.5604282538616,0.1
396,4993,5012,19,407.7346820187468,0.6333333333333333
397,5013,5067,54,381.21419406948036,1.8
398,5068,5068,0,193.83981079950038,0.0
399,5069,5071,2,289.527374922961,0.06666666666666667
400,5072,5075,3,199.71071115949667,0.1
401,5076,5076,0,326.8453344780614,0.0
402,5077,5077,0,169.8096196722468,0.0
403,5078,5082,4,315.72807974735105,0.13333333333333333
404,5083,5087,4,470.4624921886478,0.13333333333333333
405,5088,5088,0,277.41227150857935,0.0
406,5089,5096,7,436.0266307166406,0.23333333333333334
407,5097,5097,0,151.47605169706398,0.0
408,5098,5102,4,256.0086114094898,0.13333333333333333
409,5103,5103,0,435.88264874021087,0.0
410,5104,5104,0,232.44671137658304,0.0
411,5105,5105,0,581.9092946840681,0.0
412,5106,5111,5,426.9380833954487,0.16666666666666666
413,5112,5112,0,266.7611261463334,0.0
414,5113,5113,0,488.46916672781833,0.0
415,5114,5114,0,346.55711607044964,0.0
416,5115,5115,0,542.2118981277499,0.0
417,5117,5117,0,186.89830882683873,0.0
418,5118,5118,0,564.0582744433681,0.0
419,5120,5120,0,138.40019273840855,0.0
420,5121,5122,1,539.3818315595533,0.03333333333333333
421,5123,5123,0,249.82961831794603,0.0
422,5124,5124,0,425.7754586731485,0.0
423,5125,5125,0,181.5358545382657,0.0
424,5127,5130,3,351.2487823961476,0.1
425,5131,5131,0,545.9636787346307,0.0
426,5132,5132,0,210.79250063982704,0.0
427,5133,5139,6,685.9133860100216,0.2
428,5148,5148,0,225.90216229378768,0.0
429,5149,5151,2,334.8324778382626,0.06666666666666667
430,5152,5152,0,660.3458939534767,0.0
431,5153,5157,4,436.9323177492372,0.13333333333333333
432,5158,5160,2,313.66043112500734,0.06666666666666667
433,5161,5162,1,408.0151715879631,0.03333333333333333
434,5163,5169,6,272.4018650379893,0.2
435,5170,5170,0,65.83435889258236,0.0
436,5172,5174,2,252.5387751653722,0.06666666666666667
437,5175,5175,0,84.66943455282644,0.0
438,5176,5179,3,281.4018548324517,0.1
439,5180,5183,3,103.08075735947534,0.1
440,5186,5189,3,145.79845280904405,0.1
441,5191,5192,1,411.6916488613006,0.03333333333333333
442,5194,5222,28,239.90997869939184,0.9333333333333333
443,5223,5223,0,338.0819567988944,0.0
444,5224,5225,1,183.74791940672475,0.03333333333333333
445,5226,5227,1,327.9031502342063,0.03333333333333333
446,5228,5228,0,171.06947545310607,0.0
447,5229,5233,4,267.44737024865515,0.13333333333333333
448,5234,5271,37,178.18352905593557,1.2333333333333334
449,5272,5275,3,125.92339376676155,0.1
450,5277,5282,5,215.044733198438,0.16666666666666666
451,5283,5294,11,201.0051404282382,0.36666666666666664
452,5295,5316,21,185.43539266643023,0.7
453,5317,5317,0,276.8204141707391,0.0
454,5318,5318,0,108.95175176973868,0.0
455,5319,5321,2,172.98163587499326,0.06666666666666667
456,5322,5322,0,397.12184324774853,0.0
457,5323,5324,1,155.98788333697763,0.03333333333333333
458,5325,5354,29,411.20898102042025,0.9666666666666667
459,5355,5355,0,346.904209716213,0.0
460,5356,5357,1,462.5549311634818,0.03333333333333333
461,5358,5358,0,319.0306720832319,0.0
462,5359,5360,1,207.37903434197213,0.03333333333333333
463,5361,5365,4,461.73656478360317,0.13333333333333333
464,5366,5367,1,269.5277985335081,0.03333333333333333
465,5368,5387,19,436.79476822042,0.6333333333333333
466,5388,5393,5,396.60465122549067,0.16666666666666666
467,5394,5429,35,497.5453967466467,1.1666666666666667
468,5430,5445,15,507.9798557636268,0.5
469,5446,5446,0,374.995056304779,0.0
470,5447,5451,4,476.7801746479121,0.13333333333333333
471,5452,5455,3,542.6370308405848,0.1
472,5456,5456,0,367.88192779043743,0.0
473,5457,5458,1,515.5792564057251,0.03333333333333333
474,5459,5473,14,378.7530156152008,0.4666666666666667
475,5474,5474,0,509.71080688909075,0.0
476,5475,5475,0,639.5914075741285,0.0
477,5476,5478,2,466.99788358108304,0.06666666666666667
478,5479,5480,1,652.1171218873183,0.03333333333333333
479,5481,5486,5,378.4209207549918,0.16666666666666666
480,5487,5619,132,403.5915453336838,4.4
481,5620,5621,1,405.5986963669478,0.03333333333333333
482,5622,5622,0,529.1982574884074,0.0
483,5623,5623,0,634.5466538064854,0.0
484,5624,5640,16,501.07926660097706,0.5333333333333333
485,5641,5662,21,481.921268139424,0.7
486,5663,5666,3,315.0662783019786,0.1
487,5667,5667,0,419.7154504197265,0.0
488,5668,5668,0,312.98647090848306,0.0
489,5669,5669,0,508.4277348972246,0.0
490,5670,5672,2,386.6102115329429,0.06666666666666667
491,5673,5674,1,198.39996614070816,0.03333333333333333
492,5675,5687,12,240.27064310502303,0.4
493,5688,5689,1,395.9357202998292,0.03333333333333333
494,5690,5691,1,202.02201700338475,0.03333333333333333
495,5694,5701,7,82.61917058901723,0.23333333333333334
496,5703,5704,1,182.36880495341555,0.03333333333333333
497,5706,5714,8,444.93970307635726,0.26666666666666666
498,5717,5717,0,592.1488291472791,0.0
499,5718,5721,3,350.5921973305286,0.1
500,5722,5723,1,471.17254066046127,0.03333333333333333
501,5730,5730,0,214.78335715712038,0.0
502,5733,5733,0,617.7371527048501,0.0
503,5736,5736,0,295.6864696942121,0.0
504,5737,5739,2,422.86150017396653,0.06666666666666667
505,5740,5740,0,182.60560530246053,0.0
506,5741,5741,0,439.11298902594245,0.0
507,5742,5770,28,184.65885794439114,0.9333333333333333
508,5772,5772,0,284.55544359008996,0.0
509,5773,5773,0,103.23198285543121,0.0
510,5774,5783,9,216.94104219920172,0.3
511,5787,5787,0,320.17330562008954,0.0
512,5788,5850,62,262.0787568684334,2.066666666666667
513,5851,5852,1,425.5829784969769,0.03333333333333333
514,5853,5862,9,366.26193462572166,0.3
515,5864,5864,0,248.47920525859388,0.0
516,5865,5882,17,194.17978094621176,0.5666666666666667
517,5883,5889,6,292.13355562806606,0.2
518,5890,5891,1,100.39582534375099,0.03333333333333333
519,5892,5894,2,251.28573265322618,0.06666666666666667
520,5895,5929,34,142.4806345556386,1.1333333333333333
521,5931,5936,5,435.6226850422166,0.16666666666666666
522,5937,5937,0,347.9154661737171,0.0
523,5940,5942,2,125.87340722489931,0.06666666666666667
524,5944,5944,0,482.6768555189547,0.0
525,5945,5946,1,96.688114339988,0.03333333333333333
526,5947,5955,8,208.3049938107794,0.26666666666666666
527,5957,5959,2,209.19052867585845,0.06666666666666667
528,5960,5969,9,272.8109582522717,0.3
529,5970,5988,18,251.32447761891802,0.6
530,5989,5989,0,146.17989885459903,0.0
531,5990,5990,0,456.126748982609,0.0
532,5991,5994,3,290.1207755250938,0.1
533,5995,5995,0,105.54585168647189,0.0
534,5996,6019,23,142.04711571788764,0.7666666666666667
535,6020,6025,5,79.76671727296629,0.16666666666666666
536,6026,6027,1,221.91652807228488,0.03333333333333333
537,6028,6038,10,119.88069136310463,0.3333333333333333
538,6040,6040,0,333.31457726354415,0.0
539,6043,6043,0,189.85174898435594,0.0
540,6046,6050,4,266.0505875123177,0.13333333333333333
541,6052,6091,39,216.0460797949792,1.3
542,6092,6097,5,167.5365671065895,0.16666666666666666
543,6098,6099,1,323.40303653464605,0.03333333333333333
544,6100,6117,17,187.04112447460636,0.5666666666666667
545,6118,6123,5,299.51857274484365,0.16666666666666666
546,6125,6125,0,148.61909943712044,0.0
547,6129,6129,0,329.94432998227376,0.0
548,6130,6130,0,154.34276791313474,0.0
549,6131,6132,1,295.3726861726349,0.03333333333333333
550,6133,6150,17,164.24678664171677,0.5666666666666667
551,6152,6153,1,547.8520679887836,0.03333333333333333
552,6154,6154,0,151.1923738433417,0.0
553,6155,6158,3,443.27052471600234,0.1
554,6159,6166,7,165.16844377156886,0.23333333333333334
555,6167,6167,0,476.6996676700548,0.0
556,6168,6181,13,168.81704440079469,0.43333333333333335
557,6182,6190,8,502.95365235827256,0.26666666666666666
558,6191,6194,3,192.8573267567817,0.1
559,6195,6197,2,445.1125727561487,0.06666666666666667
560,6198,6198,0,114.72167760790649,0.0
561,6199,6203,4,506.3235842770674,0.13333333333333333
562,6204,6204,0,161.84368454297658,0.0
563,6205,6207,2,542.5767084529804,0.06666666666666667
564,6209,6209,0,232.6053568684969,0.0
565,6214,6215,1,487.3432470551821,0.03333333333333333
566,6216,6222,6,386.08989562412495,0.2
567,6223,6223,0,524.0475872397105,0.0
568,6225,6226,1,149.51176017224574,0.03333333333333333
569,6228,6228,0,609.4640666202705,0.0
570,6229,6235,6,408.3556747794284,0.2
571,6236,6236,0,498.13657237481556,0.0
572,6237,6237,0,287.0504412923588,0.0
573,6238,6245,7,229.88983329934575,0.23333333333333334
574,6246,6250,4,534.9133287894397,0.13333333333333333
575,6251,6254,3,385.26465104584184,0.1
576,6255,6261,6,538.441080852987,0.2
577,6262,6265,3,402.86326969005705,0.1
578,6266,6276,10,420.5669155398062,0.3333333333333333
579,6277,6277,0,202.45226251968913,0.0
580,6278,6280,2,264.9261580572747,0.06666666666666667
581,6281,6288,7,368.6322752118215,0.23333333333333334
582,6289,6290,1,287.56240869145256,0.03333333333333333
583,6291,6294,3,446.83098131258384,0.1
584,6295,6299,4,321.3148092665282,0.13333333333333333
585,6300,6300,0,578.2370518032797,0.0
586,6301,6306,5,419.28170750482406,0.16666666666666666
587,6307,6309,2,329.9311859692369,0.06666666666666667
588,6310,6310,0,178.81097605803876,0.0
589,6311,6311,0,305.81695359362,0.0
590,6312,6314,2,495.95496452020643,0.06666666666666667
591,6315,6325,10,398.2195496239377,0.3333333333333333
592,6326,6326,0,296.74987555943284,0.0
593,6327,6327,0,454.7250561006053,0.0
594,6328,6331,3,375.4835801973265,0.1
595,6332,6332,0,181.11521569467888,0.0
596,6333,6342,9,329.8111853045059,0.3
597,6343,6343,0,476.02948254046055,0.0
598,6344,6347,3,316.38379781623024,0.1
599,6348,6348,0,475.30991358356806,0.0
600,6349,6349,0,316.49461233622804,0.0
601,6350,6370,20,417.82291553640374,0.6666666666666666
602,6371,6371,0,414.97909049904615,0.0
603,6372,6604,232,485.4742880765557,7.733333333333333
604,6605,6610,5,601.1457643199548,0.16666666666666666
605,6611,6611,0,466.78560881974494,0.0
606,6612,6618,6,601.2901980978405,0.2
607,6619,6622,3,370.7400133684657,0.1
608,6623,6623,0,536.791306222944,0.0
609,6624,6624,0,361.28470692032136,0.0
610,6625,6631,6,510.59247915268907,0.2
611,6632,6632,0,330.15167893834683,0.0
612,6633,6636,3,495.9690780956704,0.1
613,6637,6662,25,391.8075744794229,0.8333333333333334
614,6673,6676,3,747.7625550333092,0.1
615,6677,6677,0,575.784153017147,0.0
616,6740,6741,1,546.675560467399,0.03333333333333333
617,6747,6747,0,409.77373999163797,0.0
618,6754,6794,40,408.47637513191876,1.3333333333333333
619,6795,6801,6,146.68472246675748,0.2
620,6839,6841,2,380.2053314596726,0.06666666666666667
621,6857,6869,12,305.09085094081786,0.4
622,6870,6875,5,269.9048294965919,0.16666666666666666
623,6876,6876,0,127.02882078763632,0.0
624,6877,6877,0,238.32449840174746,0.0
625,6878,6878,0,132.95425117475224,0.0
626,6879,6884,5,243.66583150172468,0.16666666666666666
627,6885,6885,0,535.196480477666,0.0
628,6886,6887,1,308.599954463661,0.03333333333333333
629,6888,6889,1,140.951770295534,0.03333333333333333
630,6890,6905,15,360.5567238255733,0.5
631,6906,6915,9,160.82255481215222,0.3
632,6916,6919,3,434.03037022975934,0.1
633,6920,6921,1,81.43674665545188,0.03333333333333333
634,6922,6924,2,413.89022179197184,0.06666666666666667
635,6926,6926,0,533.8830896798975,0.0
636,6927,6945,18,378.38189176571865,0.6
637,6946,6950,4,92.62729401146237,0.13333333333333333
638,6951,6955,4,271.7203678192003,0.13333333333333333
639,6956,6956,0,80.69510566938037,0.0
640,6957,6958,1,275.2823221105666,0.03333333333333333
641,6959,6960,1,380.61820006344215,0.03333333333333333
642,6964,6964,0,82.01807109955045,0.0
643,6966,6966,0,362.53248600932864,0.0
644,6968,7005,37,195.40222678541,1.2333333333333334
645,7006,7006,0,392.690004375765,0.0
646,7007,7015,8,256.8700102001201,0.26666666666666666
647,7016,7019,3,323.6839842943094,0.1
648,7020,7023,3,83.17930520177474,0.1
649,7024,7024,0,285.08503943963893,0.0
650,7025,7025,0,403.87869780215954,0.0
651,7026,7031,5,118.2790250250066,0.16666666666666666
652,7032,7046,14,439.59633087293184,0.4666666666666667
653,7047,7054,7,139.93178877437674,0.23333333333333334
654,7055,7055,0,409.96052982191674,0.0
655,7056,7056,0,146.67235823633965,0.0
656,7057,7058,1,287.30785843753983,0.03333333333333333
657,7059,7060,1,422.9275921773493,0.03333333333333333
658,7063,7063,0,279.4989727760981,0.0
659,7064,7068,4,431.0703480301161,0.13333333333333333
660,7069,7071,2,297.43550531282176,0.06666666666666667
661,7072,7073,1,418.4491683941905,0.03333333333333333
662,7074,7077,3,453.2939134880594,0.1
663,7078,7078,0,248.5867733898417,0.0
664,7079,7079,0,414.1542509779606,0.0
665,7080,7081,1,580.6264391281032,0.03333333333333333
666,7082,7083,1,413.5287465827834,0.03333333333333333
667,7084,7084,0,539.7869910141657,0.0
668,7085,7085,0,392.8566995303808,0.0
669,7086,7087,1,208.99882931985468,0.03333333333333333
670,7088,7108,20,243.78530795468228,0.6666666666666666
671,7109,7109,0,454.743051778778,0.0
672,7110,7111,1,301.12417431005997,0.03333333333333333
673,7112,7114,2,247.8568726890744,0.06666666666666667
674,7115,7116,1,205.78583157207993,0.03333333333333333
675,7117,7118,1,523.9004033034678,0.03333333333333333
676,7119,7119,0,431.16830185248983,0.0
677,7120,7123,3,530.6663524558974,0.1
678,7124,7135,11,519.9457559170388,0.36666666666666664
679,7136,7139,3,420.6377160383879,0.1
680,7140,7154,14,418.697730761609,0.4666666666666667
681,7155,7158,3,268.6156969363183,0.1
682,7159,7159,0,140.83959714032846,0.0
683,7160,7160,0,374.9349140990468,0.0
684,7161,7162,1,225.66387694431717,0.03333333333333333
685,7164,7172,8,384.4467824955454,0.26666666666666666
686,7173,7177,4,242.28134589217174,0.13333333333333333
687,7178,7183,5,373.97411413712297,0.16666666666666666
688,7184,7184,0,159.8391375167678,0.0
689,7185,7186,1,411.9368243654355,0.03333333333333333
690,7187,7187,0,279.1538102334425,0.0
691,7188,7188,0,148.86283731327123,0.0
692,7190,7190,0,469.49172192435344,0.0
693,7191,7191,0,102.93819312028926,0.0
694,7195,7195,0,217.64232938584053,0.0
695,7199,7199,0,92.14655119151094,0.0
696,7200,7202,2,337.867892236919,0.06666666666666667
697,7203,7220,17,167.5717183886064,0.5666666666666667
698,7221,7224,3,262.52311756878527,0.1
699,7225,7234,9,173.4763541662216,0.3
700,7235,7260,25,251.5312766467414,0.8333333333333334
701,7261,7262,1,85.50794700778195,0.03333333333333333
702,7263,7267,4,295.34919136750364,0.13333333333333333
703,7268,7268,0,116.96207543139653,0.0
704,7269,7277,8,314.0279857897257,0.26666666666666666
705,7278,7278,0,94.09857610962467,0.0
706,7279,7280,1,454.7726264953505,0.03333333333333333
707,7281,7281,0,339.56456890540477,0.0
708,7282,7283,1,100.66800043213443,0.03333333333333333
709,7284,7285,1,322.9171900680926,0.03333333333333333
710,7286,7286,0,211.2991184289211,0.0
711,7287,7287,0,103.75247969651303,0.0
712,7288,7288,0,408.7047290575585,0.0
713,7289,7290,1,202.77929631955246,0.03333333333333333
714,7291,7292,1,353.7346098989338,0.03333333333333333
715,7293,7293,0,453.16236194753316,0.0
716,7294,7294,0,347.04075994562595,0.0
717,7295,7297,2,182.22600003750597,0.06666666666666667
718,7298,7298,0,428.1082639452363,0.0
719,7299,7301,2,275.99860201168366,0.06666666666666667
720,7302,7302,0,191.32555781668668,0.0
721,7303,7303,0,324.22064303909934,0.0
722,7305,7322,17,181.00192766185646,0.5666666666666667
723,7323,7323,0,389.2486496570199,0.0
724,7324,7326,2,401.78623925717255,0.06666666666666667
725,7328,7332,4,425.47380943062655,0.13333333333333333
726,7333,7333,0,278.1803134776613,0.0
727,7334,7334,0,45.05204919277077,0.0
728,7335,7339,4,265.13533919259316,0.13333333333333333
729,7341,7369,28,147.80778273580904,0.9333333333333333
730,7370,7378,8,211.83020828999798,0.26666666666666666
731,7379,7380,1,343.6999264914989,0.03333333333333333
732,7381,7382,1,161.10229269806544,0.03333333333333333
733,7383,7385,2,391.37511764594564,0.06666666666666667
734,7386,7386,0,166.57032733442435,0.0
735,7387,7388,1,362.29436284800613,0.03333333333333333
736,7389,7389,0,260.7097292344554,0.0
737,7390,7420,30,290.783298058834,1.0
738,7421,7453,32,404.3229379673052,1.0666666666666667
739,7454,7510,56,352.29024404986546,1.8666666666666667
740,7511,7511,0,61.287116632219806,0.0
741,7512,7519,7,398.20520377903125,0.23333333333333334
742,7520,7533,13,363.1448084836131,0.43333333333333335
743,7534,7539,5,374.8474365279564,0.16666666666666666
744,7540,7540,0,130.01997971511557,0.0
745,7541,7541,0,272.8901257018337,0.0
746,7542,7543,1,118.65355126838664,0.03333333333333333
747,7544,7544,0,228.27700991516903,0.0
748,7545,7546,1,119.32933477072112,0.03333333333333333
749,7547,7547,0,235.9884538544941,0.0
750,7548,7548,0,120.99068612305527,0.0
751,7549,7549,0,232.95163590395558,0.0
752,7550,7550,0,112.84492438633843,0.0
753,7551,7560,9,400.62247245564646,0.3
754,7561,7562,1,230.1019834991199,0.03333333333333333
755,7563,7563,0,569.5229990344684,0.0
756,7564,7564,0,196.67614857653143,0.0
757,7565,7565,0,609.0222942682897,0.0
758,7566,7570,4,251.95016261871825,0.13333333333333333
759,7571,7572,1,191.83851086722976,0.03333333333333333
760,7573,7573,0,621.3604658262353,0.0
761,7574,7580,6,398.6922832730003,0.2
762,7581,7582,1,209.36945899719265,0.03333333333333333
763,7583,7583,0,327.28440880683894,0.0
764,7584,7584,0,99.01844207807329,0.0
765,7585,7589,4,375.10571035989807,0.13333333333333333
766,7590,7591,1,166.28748845208196,0.03333333333333333
767,7592,7600,8,417.59584208862583,0.26666666666666666
768,7601,7614,13,376.3188328898606,0.43333333333333335
769,7615,7615,0,515.0290519843021,0.0
770,7616,7618,2,356.8734866471432,0.06666666666666667
771,7619,7619,0,186.2767148650305,0.0
772,7620,7623,3,451.0055969471473,0.1
773,7624,7628,4,239.79311762710427,0.13333333333333333
774,7629,7646,17,411.6069259844962,0.5666666666666667
775,7647,7665,18,342.0719272957052,0.6
776,7666,7673,7,335.9545249997305,0.23333333333333334
777,7674,7674,0,494.1192516034369,0.0
778,7675,7678,3,462.17897402234223,0.1
779,7679,7699,20,325.09208130818223,0.6666666666666666
780,7700,7706,6,135.54800565124313,0.2
781,7707,7721,14,263.09644080026396,0.4666666666666667
782,7722,7728,6,280.2854292592429,0.2
783,7729,7736,7,232.56867769664981,0.23333333333333334
784,7737,7738,1,336.9814540457826,0.03333333333333333
785,7739,7758,19,260.24442943106317,0.6333333333333333
786,7759,7759,0,119.33974794775224,0.0
787,7760,7761,1,328.8720921957342,0.03333333333333333
788,7762,7762,0,55.971228559171095,0.0
789,7763,7776,13,342.7808527911663,0.43333333333333335
790,7777,7777,0,250.42174886240238,0.0
791,7778,7778,0,81.28115625653463,0.0
792,7779,7789,10,193.13633673622164,0.3333333333333333
793,7790,7792,2,288.4122198669599,0.06666666666666667
794,7793,7793,0,85.47205181145041,0.0
795,7794,7800,6,244.9595472946899,0.2
796,7802,7802,0,104.39083033930034,0.0
797,7803,7813,10,242.34992033109214,0.3333333333333333
798,7816,7825,9,291.311545607292,0.3
799,7834,7834,0,61.17466152173892,0.0
800,7835,7836,1,146.21131615589135,0.03333333333333333
801,7837,7859,22,360.3389738705435,0.7333333333333333
802,7860,7860,0,575.5934773815617,0.0
803,7861,7884,23,427.45109047345096,0.7666666666666667
804,7885,7885,0,568.9275066026637,0.0
805,7886,7888,2,468.65526616418293,0.06666666666666667
806,7889,7908,19,436.416135694269,0.6333333333333333
807,7924,7924,0,254.95548021019894,0.0
808,7950,7950,0,424.68939018135177,0.0
809,7963,8001,38,151.7252143042559,1.2666666666666666
810,8002,8022,20,210.9896895309746,0.6666666666666666
811,8023,8023,0,460.85825973611134,0.0
812,8024,8024,0,590.3458635217481,0.0
813,8025,8025,0,427.4965661333598,0.0
814,8026,8026,0,51.97799580145358,0.0
815,8027,8031,4,236.3025191786491,0.13333333333333333
816,8032,8032,0,439.24634362509266,0.0
817,8033,8043,10,220.17885809976423,0.3333333333333333
818,8044,8044,0,278.2265631698735,0.0
819,8045,8047,2,119.67836356148804,0.06666666666666667
820,8048,8048,0,404.9939503755429,0.0
821,8049,8055,6,170.96000583814728,0.2
822,8056,8056,0,316.62479663634787,0.0
823,8057,8067,10,155.78120961898924,0.3333333333333333
824,8068,8068,0,321.589671098741,0.0
825,8069,8069,0,433.6354621920652,0.0
826,8070,8071,1,140.44816898303765,0.03333333333333333
827,8073,8073,0,355.3088824594012,0.0
828,8074,8076,2,115.85458306455789,0.06666666666666667
829,8079,8086,7,294.78371137315213,0.23333333333333334
830,8088,8088,0,93.42648825371279,0.0
831,8089,8089,0,393.94524582252535,0.0
832,8090,8090,0,94.19139727513888,0.0
833,8091,8093,2,404.52085764852995,0.06666666666666667
834,8094,8095,1,250.82713267041606,0.03333333333333333
835,8096,8096,0,404.41208176603055,0.0
836,8098,8098,0,82.57928346070248,0.0
837,8099,8103,4,423.7632444265453,0.13333333333333333
838,8104,8105,1,134.90219696228942,0.03333333333333333
839,8113,8129,16,336.97424816273275,0.5333333333333333
840,8130,8137,7,335.2752593779031,0.23333333333333334
841,8138,8138,0,250.60249818631732,0.0
842,8139,8139,0,350.6305093504297,0.0
843,8140,8148,8,483.2038208968184,0.26666666666666666
844,8149,8149,0,322.71492738981243,0.0
845,8150,8152,2,418.55220091674,0.06666666666666667
846,8153,8153,0,469.53963236434356,0.0
847,8154,8154,0,361.4163633676187,0.0
848,8155,8161,6,443.58246424734716,0.2
849,8162,8167,5,403.17071441444676,0.16666666666666666
850,8168,8175,7,282.3598421279835,0.23333333333333334
851,8176,8176,0,417.22557964563066,0.0
852,8177,8177,0,295.3339227818588,0.0
853,8178,8208,30,411.1888384913039,1.0
854,8209,8210,1,295.7166106664372,0.03333333333333333
855,8211,8224,13,448.47668880596285,0.43333333333333335
856,8225,8227,2,498.9583500184799,0.06666666666666667
857,8228,8229,1,408.869285589597,0.03333333333333333
858,8230,8230,0,192.29993641964612,0.0
859,8231,8237,6,553.5495482474807,0.2
860,8238,8239,1,520.4008538129419,0.03333333333333333
861,8240,8240,0,232.53190481596224,0.0
862,8241,8241,0,506.19443227079023,0.0
863,8243,8243,0,365.5236278187327,0.0
864,8245,8245,0,142.1731265262017,0.0
865,8246,8252,6,389.8332091830883,0.2
866,8253,8253,0,299.4148585697173,0.0
867,8255,8260,5,404.3413990029067,0.16666666666666666
868,8261,8262,1,551.2793527167838,0.03333333333333333
869,8263,8264,1,467.6785591789615,0.03333333333333333
870,8272,8272,0,184.9560425025043,0.0
871,8273,8284,11,508.4769963242289,0.36666666666666664
872,8285,8285,0,547.3627495027737,0.0
873,8286,8286,0,653.1509531326386,0.0
874,8287,8289,2,450.0501860771815,0.06666666666666667
875,8290,8324,34,354.5890598603173,1.1333333333333333
876,8325,8330,5,376.2633137430994,0.16666666666666666
877,8331,8334,3,268.48940843397986,0.1
878,8335,8446,111,350.20078543955685,3.7
879,8447,8448,1,358.01957987975163,0.03333333333333333
880,8449,8449,0,255.74175269794392,0.0
881,8450,8450,0,357.452996419956,0.0
882,8451,8462,11,233.606728952499,0.36666666666666664
883,8463,8463,0,394.38029708304487,0.0
884,8464,8464,0,235.1974085040211,0.0
885,8465,8468,3,365.9650983296691,0.1
886,8469,8502,33,156.86131038221848,1.1
887,8503,8515,12,295.57194959661626,0.4
888,8516,8518,2,87.2579560569302,0.06666666666666667
889,8519,8519,0,378.4929707150476,0.0
890,8523,8523,0,113.13513101987998,0.0
891,8529,8544,15,309.33940315276664,0.5
892,8545,8570,25,336.7708548051482,0.8333333333333334
893,8571,8572,1,222.300492121518,0.03333333333333333
894,8573,8574,1,383.81863496867805,0.03333333333333333
895,8575,8579,4,217.96239108874943,0.13333333333333333
896,8580,8590,10,302.26214488988927,0.3333333333333333
897,8591,8604,13,175.43248826309906,0.43333333333333335
898,8605,8609,4,239.5874054070211,0.13333333333333333
899,8610,8613,3,114.2680850065211,0.1
900,8614,8625,11,217.44306980572642,0.36666666666666664
901,8627,8628,1,348.4851190658396,0.03333333333333333
902,8630,8644,14,207.84304645296075,0.4666666666666667
903,8646,8652,6,326.83423170378614,0.2
904,8653,8653,0,504.80099855230145,0.0
905,8654,8657,3,349.52208738996495,0.1
906,8658,8668,10,254.20995370267963,0.3333333333333333
907,8669,8669,0,308.45838085774767,0.0
908,8670,8671,1,497.0886761683607,0.03333333333333333
909,8672,8673,1,196.68237294297433,0.03333333333333333
910,8674,8674,0,333.1950312227653,0.0
911,8675,8678,3,197.36996866019672,0.1
912,8679,8680,1,368.6998830320699,0.03333333333333333
913,8681,8681,0,213.7353273449897,0.0
914,8682,8702,20,214.1553532018551,0.6666666666666666
915,8706,8708,2,348.9086595003688,0.06666666666666667
916,8709,8713,4,172.25031326496648,0.13333333333333333
917,8716,8725,9,258.36383953398047,0.3
918,8784,8796,12,295.5368950246714,0.4
919,8799,8847,48,318.4745388801795,1.6
920,8848,8850,2,330.9365053607282,0.06666666666666667
921,8851,8851,0,175.2779318321845,0.0
922,8852,8854,2,291.41086215253847,0.06666666666666667
923,8855,8858,3,327.76285833936765,0.1
924,8860,8863,3,172.35533501633245,0.1
925,8864,8871,7,275.37087305650095,0.23333333333333334
926,8872,8875,3,315.7365888600831,0.1
927,8876,8883,7,203.30158706284053,0.23333333333333334
928,8884,8884,0,710.9545276607711,0.0
929,8885,8885,0,510.90455358496064,0.0
930,8886,8886,0,264.0072588566905,0.0
931,8887,8887,0,523.7994414405164,0.0
932,8888,8891,3,157.60863416226476,0.1
933,8892,8895,3,603.3602306335389,0.1
934,8896,8896,0,845.2838407947625,0.0
935,8898,8899,1,357.12967286852546,0.03333333333333333
936,8900,8901,1,575.488630464753,0.03333333333333333
937,8902,8903,1,330.62792715960666,0.03333333333333333
938,8904,8905,1,575.7170643243883,0.03333333333333333
939,8906,8906,0,369.44101060362016,0.0
940,8907,8907,0,641.6266834343278,0.0
941,8909,8909,0,355.44510495344,0.0
942,8910,8910,0,641.750593200238,0.0
943,8911,8911,0,806.399914154554,0.0
944,8912,8912,0,369.56967113755724,0.0
945,8913,8915,2,215.72387196221817,0.06666666666666667
946,8920,8921,1,372.18694631532406,0.03333333333333333
947,8922,8922,0,484.87917982016415,0.0
948,8923,8926,3,377.74602231053495,0.1
949,8929,8930,1,481.8765844508579,0.03333333333333333
950,8931,8932,1,580.7758890517857,0.03333333333333333
951,8933,8934,1,457.53009024059145,0.03333333333333333
952,8935,8936,1,138.17102485023958,0.03333333333333333
953,8937,8937,0,525.8137396151923,0.0
954,8940,8940,0,373.3121488267324,0.0
955,8941,8941,0,535.2714139722008,0.0
956,8942,8942,0,210.00422443635628,0.0
957,8944,8945,1,515.0997820318638,0.03333333333333333
958,8946,8946,0,326.68520364172434,0.0
959,8947,8949,2,379.20635865776165,0.06666666666666667
960,8951,8954,3,560.3291386140818,0.1
961,8957,8960,3,322.14035001352994,0.1
962,8961,8961,0,429.2140597751889,0.0
963,8962,8962,0,254.87865792013898,0.0
964,8964,8965,1,428.1145036645124,0.03333333333333333
965,8966,8966,0,259.95271762748627,0.0
966,8967,8968,1,560.6150527374017,0.03333333333333333
967,8970,8971,1,349.2034910002079,0.03333333333333333
968,8972,8973,1,515.0353693365146,0.03333333333333333
969,8974,8976,2,375.4370034559062,0.06666666666666667
970,8977,8977,0,544.136642466704,0.0
971,8978,8978,0,424.4270259295543,0.0
972,8979,8982,3,234.1404969164978,0.1
973,9005,9029,24,327.23645164596167,0.8
974,9030,9031,1,215.6210550866495,0.03333333333333333
975,9032,9033,1,372.7158228117705,0.03333333333333333
976,9034,9036,2,256.00624242589646,0.06666666666666667
977,9037,9037,0,532.2930206593297,0.0
978,9038,9051,13,319.47958477666333,0.43333333333333335
979,9052,9053,1,112.66535485866666,0.03333333333333333
980,9054,9057,3,455.80332045872484,0.1
981,9058,9061,3,498.84114752796376,0.1
982,9062,9062,0,111.5854333618367,0.0
983,9063,9063,0,449.6385901993963,0.0
984,9064,9065,1,111.94671887756459,0.03333333333333333
985,9066,9066,0,450.275820370142,0.0
986,9067,9067,0,107.88479502246821,0.0
987,9068,9091,23,407.236290325766,0.7666666666666667
988,9092,9093,1,190.35491289992592,0.03333333333333333
989,9094,9101,7,493.10504842361945,0.23333333333333334
990,9104,9104,0,356.9569939734814,0.0
991,9109,9114,5,441.77945169078737,0.16666666666666666
992,9121,9155,34,214.34816416948,1.1333333333333333
993,9156,9156,0,573.724856912813,0.0
994,9172,9172,0,454.0638757466863,0.0
995,9173,9175,2,291.1775358477563,0.06666666666666667
996,9177,9178,1,490.55602000663134,0.03333333333333333
997,9179,9180,1,135.14769451747028,0.03333333333333333
998,9181,9187,6,481.30761341549106,0.2
999,9188,9188,0,156.90925594848,0.0
1000,9189,9190,1,220.25350973585608,0.03333333333333333
1001,9193,9202,9,429.4052949758919,0.3
1002,9203,9203,0,117.36825115703773,0.0
1003,9204,9204,0,488.1948298217374,0.0
1004,9205,9267,62,322.96601941601796,2.066666666666667
1005,9268,9288,20,359.2395074199506,0.6666666666666666
1006,9289,9289,0,430.3823016888602,0.0
1007,9290,9301,11,337.5028333348343,0.36666666666666664
1008,9302,9305,3,288.5068015945227,0.1
1009,9306,9307,1,193.62223333403062,0.03333333333333333
1010,9308,9311,3,337.2568077767838,0.1
1011,9312,9312,0,90.50207902537487,0.0
1012,9313,9314,1,215.21672102879415,0.03333333333333333
1013,9315,9315,0,354.68907245657334,0.0
1014,9318,9329,11,191.0251475418663,0.36666666666666664
1015,9330,9338,8,256.55256074019894,0.26666666666666666
1016,9339,9347,8,329.05143898649516,0.26666666666666666
1017,9348,9352,4,217.0409048881982,0.13333333333333333
1018,9353,9356,3,414.5409561523798,0.1
1019,9357,9373,16,339.8091886252203,0.5333333333333333
1020,9374,9377,3,391.8381460606659,0.1
1021,9378,9378,0,236.5334486411224,0.0
1022,9379,9386,7,433.25006064192854,0.23333333333333334
1023,9387,9387,0,168.04276378443362,0.0
1024,9388,9466,78,291.16737756056904,2.6
1025,9467,9469,2,299.44104688599526,0.06666666666666667
1026,9470,9472,2,406.000277514875,0.06666666666666667
1027,9473,9476,3,273.1881207901736,0.1
1028,9477,9489,12,376.4566054299414,0.4
1029,9490,9490,0,286.98867849795334,0.0
1030,9491,9492,1,390.46544128693427,0.03333333333333333
1031,9493,9495,2,174.7382068599935,0.06666666666666667
1032,9496,9496,0,484.27176027934456,0.0
1033,9497,9498,1,355.4259815384499,0.03333333333333333
1034,9499,9499,0,485.270021694447,0.0
1035,9500,9501,1,357.09249978908656,0.03333333333333333
1036,9502,9503,1,489.9504874621316,0.03333333333333333
1037,9504,9505,1,356.9134872105642,0.03333333333333333
1038,9507,9509,2,165.61005310797162,0.06666666666666667
1039,9515,9515,0,507.01607460426914,0.0
1040,9516,9516,0,163.33324356522252,0.0
1041,9517,9526,9,443.42013485569805,0.3
1042,9527,9527,0,124.33877354272217,0.0
1043,9528,9533,5,417.954769280072,0.16666666666666666
1044,9534,9536,2,324.95045272809006,0.06666666666666667
1045,9537,9537,0,211.08636274993506,0.0
1046,9538,9539,1,314.81785481868616,0.03333333333333333
1047,9540,9540,0,151.60094449632936,0.0
1048,9541,9545,4,304.53436750847266,0.13333333333333333
1049,9546,9546,0,426.6247742837896,0.0
1050,9547,9547,0,166.7348349331905,0.0
1051,9548,9548,0,317.22424375182516,0.0
1052,9549,9549,0,420.3769539666232,0.0
1053,9550,9552,2,123.53723459791338,0.06666666666666667
1054,9554,9556,2,517.0283317990278,0.06666666666666667
1055,9558,9558,0,154.77201831074083,0.0
1056,9559,9559,0,546.5708445093329,0.0
1057,9560,9560,0,366.18612183281357,0.0
1058,9561,9562,1,541.5969391093482,0.03333333333333333
1059,9563,9563,0,401.29715970444795,0.0
1060,9564,9564,0,556.1199874360343,0.0
1061,9565,9565,0,406.83791408915835,0.0
1062,9566,9582,16,288.0539187250987,0.5333333333333333
1063,9583,9583,0,439.85485751732864,0.0
1064,9584,9584,0,629.9187887807299,0.0
1065,9588,9592,4,323.3075383617531,0.13333333333333333
1066,9593,9594,1,491.0843047307475,0.03333333333333333
1067,9595,9597,2,348.0338132086625,0.06666666666666667
1068,9598,9598,0,468.5229314169033,0.0
1069,9599,9612,13,430.72320007609136,0.43333333333333335
1070,9613,9615,2,353.38132374545575,0.06666666666666667
1071,9617,9617,0,106.59850073440762,0.0
1072,9618,9618,0,239.13967399498173,0.0
1073,9619,9620,1,394.5243715132192,0.03333333333333333
1074,9621,9625,4,256.95333074719815,0.13333333333333333
1075,9626,9626,0,592.9117799140196,0.0
1076,9627,9627,0,756.2865992172851,0.0
1077,9628,9633,5,550.6978603061406,0.16666666666666666
1078,9634,9652,18,515.2138879892705,0.6
1079,9653,9657,4,255.52543228825243,0.13333333333333333
1080,9658,9683,25,213.39244370358318,0.8333333333333334
1081,9684,9693,9,360.06749810694305,0.3
1082,9694,9695,1,504.33245172643836,0.03333333333333333
1083,9696,9696,0,144.75449610387702,0.0
1084,9697,9698,1,338.9936413953955,0.03333333333333333
1085,9699,9699,0,145.65025313929092,0.0
1086,9700,9700,0,344.6615345228992,0.0
1087,9701,9701,0,158.28902104132803,0.0
1088,9702,9705,3,345.38431287648575,0.1
1089,9708,9708,0,525.8527789183589,0.0
1090,9716,9732,16,178.07114713130147,0.5333333333333333
1091,9734,9734,0,371.1464176920748,0.0
1092,9737,9749,12,212.68809612417792,0.4
1093,9750,9751,1,311.92689792502176,0.03333333333333333
1094,9752,9752,0,428.0760432029933,0.0
1095,9753,9754,1,517.5633931668656,0.03333333333333333
1096,9757,9757,0,374.6152427413776,0.0
1097,9758,9763,5,437.8936706201757,0.16666666666666666
1098,9764,9764,0,253.17072400455277,0.0
1099,9765,9784,19,428.0733698234708,0.6333333333333333
1100,9785,9785,0,220.20015362560744,0.0
1101,9789,9789,0,376.88720048092864,0.0
1102,9791,9793,2,272.98289629619353,0.06666666666666667
1103,9794,9794,0,498.47856629949985,0.0
1104,9802,9802,0,176.58149455770544,0.0
1105,9803,9803,0,460.6218945999233,0.0
1106,9805,9806,1,301.10063501996876,0.03333333333333333
1107,9807,9808,1,177.11050320394935,0.03333333333333333
1108,9809,9810,1,468.26291695471286,0.03333333333333333
1109,9811,9813,2,179.84877291434518,0.06666666666666667
1110,9814,9820,6,435.1787679493336,0.2
1111,9821,9822,1,63.490075692500334,0.03333333333333333
1112,9823,9823,0,174.83562783627795,0.0
1113,9824,9824,0,63.44598784423506,0.0
1114,9825,9827,2,291.0090262061714,0.06666666666666667
1115,9828,9829,1,402.9757835634793,0.03333333333333333
1116,9830,9831,1,56.607189003747024,0.03333333333333333
1117,9832,9834,2,204.46221651524215,0.06666666666666667
1118,9835,9836,1,367.8191551381616,0.03333333333333333
1119,9837,9837,0,497.01054349795237,0.0
1120,9838,9838,0,332.099792404222,0.0
1121,9839,9839,0,98.83211136430207,0.0
1122,9840,9846,6,470.1326807196136,0.2
1123,9849,9849,0,210.25302311629238,0.0
1124,9850,9850,0,440.53588512285273,0.0
1125,9862,9889,27,207.73947930325718,0.9
1126,9892,9894,2,381.71837432877373,0.06666666666666667
1127,9898,9903,5,120.750723723247,0.16666666666666666
1128,9904,9927,23,171.32406408164846,0.7666666666666667
1129,9928,9978,50,322.47760536942485,1.6666666666666667
1130,9979,9981,2,209.35817628311995,0.06666666666666667
1131,9982,9984,2,380.45625214076773,0.06666666666666667
1132,9985,10002,17,419.85597059240587,0.5666666666666667
1133,10003,10003,0,230.4982852940698,0.0
1134,10004,10039,35,446.80600332245604,1.1666666666666667
1135,10040,10048,8,399.8357182604669,0.26666666666666666
1136,10049,10049,0,276.28050442559424,0.0
1137,10050,10093,43,457.0982310383535,1.4333333333333333
1138,10095,10097,2,754.4609224463388,0.06666666666666667
1139,10098,10100,2,522.550252882758,0.06666666666666667
1140,10102,10102,0,81.44088535162246,0.0
1141,10103,10103,0,283.05489092613436,0.0
1142,10106,10106,0,49.73751765578875,0.0
1143,10126,10126,0,439.78001060587485,0.0
1144,10127,10129,2,144.46428344747406,0.06666666666666667
1145,10132,10132,0,567.4040480461011,0.0
1146,10133,10133,0,703.5065374788229,0.0
1147,10134,10134,0,566.2863620682645,0.0
1148,10148,10148,0,110.70893987267827,0.0
1149,10163,10163,0,548.5107280469016,0.0
1150,10215,10223,8,350.45283527127174,0.26666666666666666
1151,10250,10254,4,161.13867827060093,0.13333333333333333
1152,10267,10267,0,326.8135288405774,0.0
1153,10363,10363,0,301.9117457865961,0.0
1154,10413,10413,0,136.07239689276372,0.0
1155,10429,10443,14,214.21466823540248,0.4666666666666667
1156,10444,10444,0,327.2139806771952,0.0
1157,10445,10447,2,170.77407990758468,0.06666666666666667
1158,10448,10454,6,257.2190384005962,0.2
1159,10455,10459,4,386.11121742691233,0.13333333333333333
1160,10460,10460,0,172.17141640441287,0.0
1161,10461,10468,7,416.3104951876745,0.23333333333333334
1162,10469,10469,0,171.12780474041972,0.0
1163,10470,10475,5,257.32041740331056,0.16666666666666666
1164,10477,10478,1,363.88171003823425,0.03333333333333333
1165,10479,10484,5,255.27262110573415,0.16666666666666666
1166,10485,10486,1,374.4841405473749,0.03333333333333333
1167,10487,10518,31,245.99155844002092,1.0333333333333334
1168,10519,10520,1,71.22746046476638,0.03333333333333333
1169,10521,10532,11,148.66784795992754,0.36666666666666664
1170,10533,10538,5,255.34980207912244,0.16666666666666666
1171,10539,10546,7,136.21597015925752,0.23333333333333334
1172,10547,10547,0,368.4590229224444,0.0
1173,10548,10561,13,169.82896116577055,0.43333333333333335
1174,10562,10563,1,136.9084383808406,0.03333333333333333
1175,10564,10564,0,258.72752533374114,0.0
1176,10565,10565,0,139.2004028382768,0.0
1177,10566,10573,7,300.8650872598157,0.23333333333333334
1178,10574,10574,0,370.3154005068622,0.0
1179,10575,10575,0,263.73191900430567,0.0
1180,10576,10577,1,183.79271130982403,0.03333333333333333
1181,10578,10588,10,324.9760278858379,0.3333333333333333
1182,10589,10595,6,248.5026280460481,0.2
1183,10596,10598,2,319.4552148835667,0.06666666666666667
1184,10599,10609,10,254.52524739130524,0.3333333333333333
1185,10610,10610,0,209.1288163485675,0.0
1186,10611,10619,8,339.97862094631756,0.26666666666666666
1187,10620,10620,0,232.30930768265128,0.0
1188,10621,10621,0,374.3138185805371,0.0
1189,10622,10622,0,236.04536021783542,0.0
1190,10623,10670,47,390.4558218232308,1.5666666666666667
1191,10671,10676,5,390.1643090179889,0.16666666666666666
1192,10677,10682,5,284.4536663024035,0.16666666666666666
1193,10683,10683,0,238.92467503165736,0.0
1194,10684,10704,20,276.29667724327237,0.6666666666666666
1195,10705,10706,1,393.2981256270998,0.03333333333333333
1196,10707,10707,0,184.04092916139925,0.0
1197,10708,10710,2,277.2008577638518,0.06666666666666667
1198,10711,10711,0,370.9236890991946,0.0
1199,10712,10717,5,285.03574089326145,0.16666666666666666
1200,10718,10718,0,500.2293232935615,0.0
1201,10719,10721,2,316.8107073672838,0.06666666666666667
1202,10722,10729,7,462.2793384861618,0.23333333333333334
1203,10730,10730,0,202.6648505462017,0.0
1204,10731,10733,2,504.3087340584303,0.06666666666666667
1205,10734,10738,4,370.53648930764365,0.13333333333333333
1206,10741,10743,2,498.95625172585966,0.06666666666666667
1207,10746,10751,5,339.5044849364366,0.16666666666666666
1208,10752,10752,0,228.47700718200474,0.0
1209,10753,10756,3,298.28371408964836,0.1
1210,10758,10758,0,628.1003234725127,0.0
1211,10762,10762,0,311.38749631984894,0.0
1212,10764,10766,2,188.55060639242163,0.06666666666666667
1213,10768,10774,6,353.38001496924227,0.2
1214,10775,10778,3,264.94939781874837,0.1
1215,10789,10798,9,242.97655730346673,0.3
1216,10803,10803,0,116.89284052388969,0.0
1217,10804,10805,1,504.48553411309524,0.03333333333333333
1218,10807,10812,5,296.8684094811081,0.16666666666666666
1219,10813,10813,0,83.20987903000753,0.0
1220,10814,10817,3,244.3278786260508,0.1
1221,10818,10818,0,386.5618507434841,0.0
1222,10819,10820,1,495.16746313415456,0.03333333333333333
1223,10821,10821,0,98.94048732202343,0.0
1224,10822,10822,0,279.5377561563499,0.0
1225,10823,10823,0,101.3242544291344,0.0
1226,10824,10825,1,272.1256883291355,0.03333333333333333
1227,10826,10826,0,400.0380300870041,0.0
1228,10827,10827,0,227.22323744964174,0.0
1229,10828,10839,11,426.5829864035417,0.36666666666666664
1230,10840,10843,3,230.53516363520586,0.1
1231,10844,10852,8,385.6670255490766,0.26666666666666666
1232,10853,10867,14,185.80135428188677,0.4666666666666667
1233,10868,10876,8,379.0683224596562,0.26666666666666666
1234,10877,10877,0,146.9277918453807,0.0
1235,10878,10921,43,225.59683368133372,1.4333333333333333
1236,10922,10922,0,301.49680357841515,0.0
1237,10923,10923,0,171.26956893339909,0.0
1238,10924,10924,0,299.41664733164663,0.0
1239,10925,10955,30,207.48261840486168,1.0
1240,10956,10957,1,180.6626458436192,0.03333333333333333
1241,10958,10959,1,331.637625439482,0.03333333333333333
1242,10960,10960,0,193.52255782759767,0.0
1243,10961,10962,1,280.01709040822533,0.03333333333333333
1244,10963,10994,31,390.49272645384997,1.0333333333333334
1245,10996,10999,3,136.61780599292987,0.1
1246,11001,11007,6,78.08910596308789,0.2
1247,11008,11008,0,316.251238754191,0.0
1248,11011,11014,3,85.42363690783492,0.1
1249,11024,11030,6,299.167577503195,0.2
1250,11031,11032,1,423.2617343801883,0.03333333333333333
1251,11033,11054,21,539.8546611710467,0.7
1252,11055,11069,14,385.5077714799128,0.4666666666666667
1253,11070,11070,0,595.7239326734299,0.0
1254,11071,11073,2,481.1927257654581,0.06666666666666667
1255,11074,11075,1,593.1046378059774,0.03333333333333333
1256,11076,11076,0,152.30278866121998,0.0
1257,11077,11081,4,503.1355632820276,0.13333333333333333
1258,11082,11082,0,223.5852718206823,0.0
1259,11083,11083,0,642.7867779416674,0.0
1260,11084,11089,5,218.16218708848464,0.16666666666666666
1261,11090,11090,0,281.6061508742221,0.0
1262,11091,11093,2,151.70214504950255,0.06666666666666667
1263,11094,11094,0,240.09922718439978,0.0
1264,11095,11098,3,549.6548402007802,0.1
1265,11099,11099,0,272.35961804559764,0.0
1266,11100,11101,1,516.16634502195,0.03333333333333333
1267,11102,11106,4,596.8569283674345,0.13333333333333333
1268,11107,11108,1,739.180113719958,0.03333333333333333
1269,11109,11109,0,529.5056014633072,0.0
1270,11110,11110,0,710.8784204409931,0.0
1271,11111,11114,3,268.35117784094734,0.1
1272,11115,11117,2,645.2616604688459,0.06666666666666667
1273,11118,11120,2,441.56756304688616,0.06666666666666667
1274,11121,11122,1,331.1092023598047,0.03333333333333333
1275,11123,11123,0,471.6271933592903,0.0
1276,11124,11129,5,320.0195772958958,0.16666666666666666
1277,11130,11131,1,490.2101331375891,0.03333333333333333
1278,11134,11134,0,290.3009887006964,0.0
1279,11135,11146,11,338.3683813777719,0.36666666666666664
1280,11147,11147,0,263.4766262259683,0.0
1281,11148,11150,2,555.7022453658394,0.06666666666666667
1282,11151,11151,0,672.3413023721469,0.0
1283,11152,11158,6,487.8797577347231,0.2
1284,11159,11160,1,628.8803612944721,0.03333333333333333
1285,11161,11161,0,440.12892320779196,0.0
1286,11162,11162,0,622.8953692027511,0.0
1287,11163,11166,3,433.548010727768,0.1
1288,11167,11169,2,599.1889228658853,0.06666666666666667
1289,11171,11172,1,409.7296088511779,0.03333333333333333
1290,11173,11173,0,241.3754555475576,0.0
1291,11174,11175,1,395.91168192832254,0.03333333333333333
1292,11176,11182,6,564.0024865036721,0.2
1293,11183,11183,0,335.49985112957194,0.0
1294,11184,11190,6,304.91150519685306,0.2
1295,11191,11191,0,510.52845914901957,0.0
1296,11192,11192,0,406.62911748281635,0.0
1297,11193,11199,6,295.987637272175,0.2
1298,11200,11207,7,329.9783106813749,0.23333333333333334
1299,11208,11208,0,272.0218736031903,0.0
1300,11209,11210,1,401.7768333897891,0.03333333333333333
1301,11211,11221,10,265.45150315425155,0.3333333333333333
1302,11222,11226,4,318.5662177153787,0.13333333333333333
1303,11227,11227,0,356.4879814165548,0.0
1304,11228,11236,8,315.20694099636484,0.26666666666666666
1305,11237,11248,11,244.14238766377534,0.36666666666666664
1306,11249,11249,0,423.1685196264067,0.0
1307,11250,11251,1,288.9641676177403,0.03333333333333333
1308,11252,11255,3,441.3273853804717,0.1
1309,11256,11260,4,310.5600190742758,0.13333333333333333
1310,11261,11261,0,435.12274147990485,0.0
1311,11262,11262,0,145.16909458825447,0.0
1312,11263,11265,2,312.88730394731004,0.06666666666666667
1313,11266,11273,7,170.47646880314426,0.23333333333333334
1314,11274,11274,0,326.7047095873093,0.0
1315,11275,11283,8,220.5718469412011,0.26666666666666666
1316,11284,11289,5,298.79452565231804,0.16666666666666666
1317,11290,11290,0,205.34340300906604,0.0
1318,11291,11302,11,333.3671159360487,0.36666666666666664
1319,11303,11319,16,326.4027541575263,0.5333333333333333
1320,11320,11321,1,238.18550378274392,0.03333333333333333
1321,11322,11330,8,334.2436268519841,0.26666666666666666
1322,11331,11331,0,438.322168025639,0.0
1323,11332,11332,0,319.7358114725817,0.0
1324,11333,11333,0,500.1276520059974,0.0
1325,11334,11334,0,230.32254338260668,0.0
1326,11335,11337,2,425.27142100042494,0.06666666666666667
1327,11338,11341,3,349.4112061229545,0.1
1328,11342,11343,1,175.69089575994855,0.03333333333333333
1329,11344,11380,36,333.41846908187455,1.2
1330,11381,11385,4,503.16091125396633,0.13333333333333333
1331,11386,11387,1,354.19089905399494,0.03333333333333333
1332,11388,11388,0,480.3094139480989,0.0
1333,11389,11389,0,352.7887218796129,0.0
1334,11390,11391,1,482.7204052018136,0.03333333333333333
1335,11392,11399,7,336.3459236977365,0.23333333333333334
1336,11400,11404,4,494.3337986676037,0.13333333333333333
1337,11405,11405,0,347.8869713880053,0.0
1338,11406,11406,0,470.03576044215276,0.0
1339,11407,11408,1,351.0249993360625,0.03333333333333333
1340,11409,11414,5,487.4299040855233,0.16666666666666666
1341,11415,11415,0,462.3050584639791,0.0
1342,11416,11417,1,330.234250420306,0.03333333333333333
1343,11418,11419,1,398.4301393936291,0.03333333333333333
1344,11420,11420,0,251.76754490361768,0.0
1345,11421,11444,23,449.1951380621246,0.7666666666666667
1346,11445,11445,0,148.41832218203638,0.0
1347,11446,11456,10,426.42968619178134,0.3333333333333333
1348,11457,11467,10,415.59551521566175,0.3333333333333333
1349,11468,11468,0,154.23166072420096,0.0
1350,11469,11535,66,365.7503484828349,2.2
1351,11536,11538,2,367.8815175692475,0.06666666666666667
1352,11539,11588,49,359.15976710618924,1.6333333333333333
1353,11589,11594,5,287.79262344916503,0.16666666666666666
1354,11595,11610,15,351.56904287172154,0.5
1355,11611,11611,0,206.01674489638302,0.0
1356,11612,11614,2,358.36256641641904,0.06666666666666667
1357,11615,11630,15,223.1567776258221,0.5
1358,11631,11631,0,121.88789844831635,0.0
1359,11632,11635,3,266.18557520457165,0.1
1360,11636,11637,1,365.48000630758054,0.03333333333333333
1361,11687,11714,27,357.51929174699035,0.9
1362,11715,11716,1,301.3316215958123,0.03333333333333333
1363,11717,11719,2,137.57116087889457,0.06666666666666667
1364,11720,11731,11,347.19812692649765,0.36666666666666664
1365,11732,11739,7,332.2222599860935,0.23333333333333334
1366,11740,11740,0,270.27969007058635,0.0
1367,11741,11741,0,159.01000356355706,0.0
1368,11742,11742,0,405.05526231976995,0.0
1369,11743,11743,0,172.9772591939396,0.0
1370,11744,11748,4,275.3407822467085,0.13333333333333333
1371,11749,11763,14,235.12847416004186,0.4666666666666667
1372,11764,11767,3,141.2322482813891,0.1
1373,11768,11768,0,263.04710657178646,0.0
1374,11769,11775,6,290.71728538759396,0.2
1375,11776,11778,2,293.165157896131,0.06666666666666667
1376,11779,11784,5,259.49800371541005,0.16666666666666666
1377,11785,11792,7,73.8295412865443,0.23333333333333334
1378,11793,11793,0,231.44891620015036,0.0
1379,11794,11794,0,61.861640911157174,0.0
1380,11795,11801,6,175.63890497269824,0.2
1381,11807,11809,2,310.9863547760125,0.06666666666666667
1382,11810,11810,0,198.5987377607929,0.0
1383,11811,11812,1,66.66007136260475,0.03333333333333333
1384,11813,11818,5,311.9366925590082,0.16666666666666666
1385,11819,11827,8,296.3163225453379,0.26666666666666666
1386,11828,11829,1,260.9027027129187,0.03333333333333333
1387,11830,11834,4,435.9266816933001,0.13333333333333333
1388,11835,11843,8,362.0094957753471,0.26666666666666666
1389,11844,11859,15,384.378191940781,0.5
1390,11860,11860,0,285.19881522833816,0.0
1391,11861,11871,10,399.6811520382719,0.3333333333333333
1392,11872,11886,14,469.67941978267055,0.4666666666666667
1393,11887,11894,7,142.03687796798815,0.23333333333333334
1394,11895,11901,6,354.6405667792118,0.2
1395,11902,11904,2,206.36670375090094,0.06666666666666667
1396,11905,11924,19,377.32411371276925,0.6333333333333333
1397,11925,11930,5,473.99568904208036,0.16666666666666666
1398,11931,11931,0,197.37017410511953,0.0
1399,11932,11932,0,519.7609405047084,0.0
1400,11933,11933,0,214.5412010652369,0.0
1401,11936,11936,0,396.438822491891,0.0
1402,11938,11938,0,165.44158757265828,0.0
1403,11940,11950,10,94.84963694549407,0.3333333333333333
1404,11951,11951,0,529.1385604442187,0.0
1405,11962,11969,7,298.13067656139117,0.23333333333333334
1406,11970,11984,14,251.3918316884147,0.4666666666666667
1407,11986,11986,0,291.41683726423406,0.0
1408,11987,11994,7,386.18948174616645,0.23333333333333334
1409,11995,11999,4,210.77271457304596,0.13333333333333333
1410,12000,12004,4,382.4876500576876,0.13333333333333333
1411,12009,12014,5,502.6055855783823,0.16666666666666666
1412,12015,12015,0,362.1530760215865,0.0
1413,12016,12025,9,527.0196052947572,0.3
1414,12026,12033,7,492.77865142879796,0.23333333333333334
1415,12034,12035,1,539.1734040979354,0.03333333333333333
1416,12036,12037,1,351.01739983481673,0.03333333333333333
1417,12038,12040,2,550.8161303653575,0.06666666666666667
1418,12041,12043,2,461.9069795063553,0.06666666666666667
1419,12044,12053,9,403.89473128681396,0.3
1420,12054,12054,0,168.76604585446304,0.0
1421,12055,12055,0,270.8644818363986,0.0
1422,12056,12060,4,468.23994652671325,0.13333333333333333
1423,12061,12063,2,272.3373334772487,0.06666666666666667
1424,12064,12106,42,308.2710744767931,1.4
1425,12107,12129,22,258.8169199775521,0.7333333333333333
1426,12130,12133,3,239.51559566821382,0.1
1427,12134,12140,6,352.36070772118063,0.2
1428,12141,12142,1,278.0387619107113,0.03333333333333333
1429,12143,12148,5,405.01907119080647,0.16666666666666666
1430,12149,12149,0,441.6179015050574,0.0
1431,12150,12154,4,325.6763948025062,0.13333333333333333
1432,12155,12155,0,457.58139492290593,0.0
1433,12156,12201,45,381.79723247350006,1.5
1434,12202,12203,1,515.6615174544975,0.03333333333333333
1435,12204,12206,2,370.5862683409291,0.06666666666666667
1436,12207,12210,3,433.99231136845367,0.1
1437,12211,12212,1,611.935147892694,0.03333333333333333
1438,12213,12215,2,373.2478150110792,0.06666666666666667
1439,12216,12216,0,227.38936805252897,0.0
1440,12217,12219,2,374.70184043762083,0.06666666666666667
1441,12220,12221,1,222.89298063358711,0.03333333333333333
1442,12222,12225,3,379.7902532075115,0.1
1443,12226,12228,2,488.24855574281423,0.06666666666666667
1444,12229,12229,0,322.16520766508347,0.0
1445,12230,12230,0,572.8810159609365,0.0
1446,12231,12238,7,484.01320243216594,0.23333333333333334
1447,12239,12239,0,318.4921825775234,0.0
1448,12240,12240,0,518.2730009138791,0.0
1449,12241,12241,0,176.91603526926784,0.0
1450,12242,12243,1,472.1756761067981,0.03333333333333333
1451,12244,12244,0,612.8007922876543,0.0
1452,12245,12246,1,445.7998685171709,0.03333333333333333
1453,12247,12251,4,638.7366145205154,0.13333333333333333
1454,12252,12253,1,439.86811204533285,0.03333333333333333
1455,12254,12254,0,641.2999987692818,0.0
1456,12255,12256,1,472.31824197838586,0.03333333333333333
1457,12257,12257,0,657.1256226601945,0.0
1458,12258,12258,0,143.49943458228137,0.0
1459,12259,12262,3,673.4011416499907,0.1
1460,12263,12263,0,472.2190076167758,0.0
1461,12264,12264,0,344.98330260925974,0.0
1462,12265,12265,0,511.1894122728382,0.0
1463,12266,12266,0,630.5969590482973,0.0
1464,12267,12267,0,479.3471205870246,0.0
1465,12268,12269,1,663.6749935919759,0.03333333333333333
1466,12270,12271,1,561.1804894028419,0.03333333333333333
1467,12272,12272,0,720.5374367225654,0.0
1468,12273,12273,0,143.2217790094995,0.0
1469,12274,12274,0,501.8980187463718,0.0
1470,12275,12276,1,397.79160919711956,0.03333333333333333
1471,12278,12278,0,533.5584460691064,0.0
1472,12279,12279,0,344.142721105587,0.0
1473,12280,12280,0,496.32148906147665,0.0
1474,12281,12281,0,135.21477014285844,0.0
1475,12282,12284,2,494.61372743908686,0.06666666666666667
1476,12285,12288,3,328.34074603657484,0.1
1477,12289,12290,1,358.9863837319093,0.03333333333333333
1478,12291,12291,0,425.77399369741244,0.0
1479,12292,12294,2,605.0384793967097,0.06666666666666667
1480,12295,12299,4,314.6837293768849,0.13333333333333333
1481,12300,12300,0,160.63092380219808,0.0
1482,12301,12303,2,368.40930593719094,0.06666666666666667
1483,12304,12314,10,443.5679643189107,0.3333333333333333
1484,12315,12315,0,98.12238135988595,0.0
1485,12316,12316,0,347.05782407717663,0.0
1486,12317,12317,0,471.3040553103004,0.0
1487,12318,12327,9,448.18604721840876,0.3
1488,12330,12343,13,230.489950654858,0.43333333333333335
1489,12344,12345,1,370.9895336324513,0.03333333333333333
1490,12346,12374,28,171.38185270380575,0.9333333333333333
1491,12390,12394,4,75.33583200255337,0.13333333333333333
1492,12395,12396,1,497.55315708641,0.03333333333333333
1493,12397,12397,0,81.38856189912525,0.0
1494,12398,12400,2,548.7772253343655,0.06666666666666667
1495,12401,12402,1,79.69655625345517,0.03333333333333333
1496,12403,12404,1,528.382832274714,0.03333333333333333
1497,12405,12405,0,82.21537060809543,0.0
1498,12406,12411,5,420.42702786884365,0.16666666666666666
1499,12412,12412,0,162.70724268467936,0.0
1500,12413,12415,2,442.08468384457893,0.06666666666666667
1501,12416,12416,0,324.3645252172214,0.0
1502,12417,12417,0,92.096026856458,0.0
1503,12418,12418,0,459.959938035644,0.0
1504,12419,12430,11,359.6130836954376,0.36666666666666664
1505,12431,12431,0,254.34978768509254,0.0
1506,12432,12434,2,431.3383845312084,0.06666666666666667
1507,12435,12442,7,346.3835829700927,0.23333333333333334
1508,12443,12448,5,327.433432368732,0.16666666666666666
1509,12449,12450,1,140.30601926333352,0.03333333333333333
1510,12451,12451,0,322.52091035809013,0.0
1511,12452,12452,0,132.4056427262791,0.0
1512,12453,12455,2,326.0306980789464,0.06666666666666667
1513,12456,12457,1,457.7901181870245,0.03333333333333333
1514,12458,12458,0,696.0829441644356,0.0
1515,12459,12463,4,327.6959441040661,0.13333333333333333
1516,12464,12465,1,291.5162919221508,0.03333333333333333
1517,12466,12474,8,267.1113747579387,0.26666666666666666
1518,12475,12475,0,45.42307761143028,0.0
1519,12476,12480,4,313.40889975570406,0.13333333333333333
1520,12481,12481,0,546.222874304923,0.0
1521,12482,12484,2,365.8339766653742,0.06666666666666667
1522,12485,12488,3,441.9435636033629,0.1
1523,12489,12489,0,625.1677060046579,0.0
1524,12490,12492,2,509.3372502227733,0.06666666666666667
1525,12493,12494,1,321.694937547466,0.03333333333333333
1526,12495,12495,0,618.4453151729001,0.0
1527,12496,12496,0,128.94816059428254,0.0
1528,12497,12499,2,510.32286499010996,0.06666666666666667
1529,12501,12503,2,342.69339813679454,0.06666666666666667
1530,12505,12507,2,602.8717877386118,0.06666666666666667
1531,12508,12510,2,491.45677197419826,0.06666666666666667
1532,12511,12511,0,381.87247824129537,0.0
1533,12512,12512,0,122.94249152979474,0.0
1534,12513,12514,1,700.1100434303919,0.03333333333333333
1535,12515,12515,0,559.3582494155146,0.0
1536,12516,12517,1,697.9932094279693,0.03333333333333333
1537,12518,12518,0,85.4118325704479,0.0
1538,12519,12523,4,429.8451848503208,0.13333333333333333
1539,12524,12524,0,252.42186530497528,0.0
1540,12525,12527,2,462.46169416085246,0.06666666666666667
1541,12528,12528,0,282.99534899876045,0.0
1542,12529,12530,1,467.045340808609,0.03333333333333333
1543,12531,12532,1,264.7146488118076,0.03333333333333333
1544,12533,12538,5,516.5414934598358,0.16666666666666666
1545,12539,12539,0,295.2397058731458,0.0
1546,12540,12542,2,497.9104859932724,0.06666666666666667
1547,12543,12543,0,636.5792785044981,0.0
1548,12544,12546,2,488.1626750669891,0.06666666666666667
1549,12547,12547,0,138.5058627322901,0.0
1550,12548,12553,5,378.3329206541907,0.16666666666666666
1551,12555,12556,1,322.8649119891552,0.03333333333333333
1552,12557,12557,0,514.124379181433,0.0
1553,12558,12558,0,667.8664885773185,0.0
1554,12559,12559,0,516.3978731333156,0.0
1555,12560,12560,0,207.43403466233798,0.0
1556,12561,12561,0,460.18105014488583,0.0
1557,12562,12565,3,350.26050209803185,0.1
1558,12566,12567,1,485.073911916527,0.03333333333333333
1559,12568,12568,0,256.32481726894736,0.0
1560,12569,12571,2,387.48665637414234,0.06666666666666667
1561,12572,12572,0,172.34863898504676,0.0
1562,12573,12573,0,414.86614377518674,0.0
1563,12574,12591,17,375.3022468435753,0.5666666666666667
1564,12592,12594,2,300.7348248899133,0.06666666666666667
1565,12595,12595,0,434.8454338830666,0.0
1566,12596,12596,0,537.4570446385557,0.0
1567,12597,12597,0,420.8838480868413,0.0
1568,12598,12598,0,522.7265287925346,0.0
1569,12600,12601,1,197.97241675650318,0.03333333333333333
1570,12602,12603,1,507.69211297205754,0.03333333333333333
1571,12604,12607,3,207.2538788659566,0.1
1572,12608,12608,0,393.0724678563913,0.0
1573,12609,12612,3,220.70363732792197,0.1
1574,12613,12614,1,348.1749804053944,0.03333333333333333
1575,12615,12633,18,212.95008491544633,0.6
1576,12634,12649,15,387.8844390587716,0.5
1577,12650,12679,29,412.8084862450594,0.9666666666666667
1578,12680,12680,0,233.38809442194906,0.0
1579,12681,12721,40,416.07102892034516,1.3333333333333333
1580,12722,12724,2,349.31565785689025,0.06666666666666667
1581,12725,12726,1,299.46100693303083,0.03333333333333333
1582,12727,12727,0,471.80256823493727,0.0
1583,12728,12749,21,308.6143848022433,0.7
1584,12750,12753,3,321.42175899302936,0.1
1585,12754,12754,0,469.9241744637091,0.0
1586,12755,12755,0,622.3556850951923,0.0
1587,12756,12759,3,442.5585248236016,0.1
1588,12760,12760,0,630.6679218980116,0.0
1589,12761,12768,7,482.4520261057198,0.23333333333333334
1590,12784,12784,0,252.9726309239547,0.0
1591,12818,12828,10,633.0900738391038,0.3333333333333333
1592,12829,12829,0,503.5143536468884,0.0
1593,12830,12835,5,617.5016260941833,0.16666666666666666
1594,12862,12864,2,295.19892061669003,0.06666666666666667
1595,12865,12865,0,536.6172739020678,0.0
1596,12876,12878,2,130.63849274189016,0.06666666666666667
1597,12886,12887,1,291.3776308355036,0.03333333333333333
1598,12907,12907,0,69.47921140208379,0.0
1599,12911,12911,0,250.44904188765767,0.0
1600,12912,12912,0,73.70638357595313,0.0
1601,12913,12915,2,249.1819718407966,0.06666666666666667
1602,12916,12916,0,92.7465537892891,0.0
1603,12917,12928,11,295.95333996721234,0.36666666666666664
1604,12932,12933,1,498.0014893996089,0.03333333333333333
1605,12934,12935,1,101.98868043064431,0.03333333333333333
1606,12940,12953,13,347.076492442593,0.43333333333333335
1607,12955,12956,1,571.563748199152,0.03333333333333333
1608,12957,12958,1,394.95590273096957,0.03333333333333333
1609,12959,12959,0,553.9662615254539,0.0
1610,12962,12964,2,462.2248299654811,0.06666666666666667
1611,12965,12965,0,348.7529863671083,0.0
1612,12966,12967,1,474.48148866759175,0.03333333333333333
1613,12968,12998,30,357.512094192065,1.0
1614,12999,13004,5,317.55828478261276,0.16666666666666666
1615,13024,13024,0,137.37936032381148,0.0
1616,13032,13032,0,448.8123680234774,0.0
1617,13037,13037,0,739.5723066846328,0.0
1618,13038,13038,0,533.9602342708586,0.0
1619,13039,13039,0,726.0012745544801,0.0
1620,13040,13047,7,366.48282795828567,0.23333333333333334
1621,13050,13051,1,113.5681539486932,0.03333333333333333
1622,13052,13052,0,314.77407322832147,0.0
1623,13053,13053,0,157.18447997560247,0.0
1624,13054,13054,0,323.4710434358227,0.0
1625,13055,13073,18,131.9539827154201,0.6
1626,13074,13074,0,513.2323761911657,0.0
1627,13075,13079,4,158.32026463363746,0.13333333333333333
1628,13084,13087,3,536.8722466033211,0.1
1629,13088,13098,10,330.92675091550154,0.3333333333333333
1630,13099,13108,9,409.2025436857605,0.3
1631,13109,13188,79,378.5107692533109,2.6333333333333333
1632,13189,13193,4,609.8814370751257,0.13333333333333333
1633,13194,13194,0,127.02996385830802,0.0
1634,13195,13197,2,538.2291062910602,0.06666666666666667
1635,13198,13198,0,593.6276859979001,0.0
1636,13199,13205,6,413.33975858676797,0.2
1637,13206,13248,42,388.1815531873975,1.4
1638,13249,13259,10,372.87774144292075,0.3333333333333333
1639,13260,13264,4,237.2311722197763,0.13333333333333333
1640,13265,13268,3,506.5154189901699,0.1
1641,13269,13269,0,744.8316225516938,0.0
1642,13270,13270,0,102.03277942364204,0.0
1643,13271,13272,1,295.31647652621274,0.03333333333333333
1644,13273,13287,14,518.0962880878071,0.4666666666666667
1645,13292,13312,20,359.16258420884213,0.6666666666666666
1646,13313,13313,0,298.63384183815145,0.0
1647,13318,13318,0,452.4289870107038,0.0
1648,13320,13321,1,318.91546847313566,0.03333333333333333
1649,13328,13328,0,168.5179229676031,0.0
1650,13329,13330,1,422.01293168944295,0.03333333333333333
1651,13331,13331,0,278.2954105473956,0.0
1652,13332,13335,3,424.3312332741561,0.1
1653,13336,13336,0,256.5384331675907,0.0
1654,13337,13344,7,302.69128802607156,0.23333333333333334
1655,13347,13347,0,117.07554163392474,0.0
1656,13348,13350,2,317.8390927531821,0.06666666666666667
1657,13351,13353,2,104.14712337127919,0.06666666666666667
1658,13354,13356,2,155.91666398636036,0.06666666666666667
1659,13358,13359,1,249.03199987287033,0.03333333333333333
1660,13361,13361,0,54.93898470276066,0.0
1661,13363,13376,13,244.28836289806546,0.43333333333333335
1662,13389,13389,0,539.9958934839867,0.0
1663,13391,13391,0,322.89992526513214,0.0
1664,13392,13404,12,168.42735946461113,0.4
1665,13412,13412,0,488.39740990157446,0.0
1666,13416,13416,0,358.63125831374555,0.0
1667,13426,13426,0,717.6264549903104,0.0
1668,13428,13428,0,583.961068493995,0.0
1669,13429,13430,1,701.1431327226662,0.03333333333333333
1670,13434,13434,0,305.7040913491326,0.0
1671,13458,13462,4,614.5416318495667,0.13333333333333333
1672,13465,13465,0,532.1924080923397,0.0
1673,13466,13466,0,144.75613588291574,0.0
1674,13510,13510,0,107.35203497999235,0.0
1675,13516,13516,0,324.9820428832848,0.0
1676,13522,13534,12,182.4684281082686,0.4
1677,13535,13536,1,94.58073805500767,0.03333333333333333
1678,13537,13550,13,234.8123812617977,0.43333333333333335
1679,13554,13560,6,211.71693709992132,0.2
1680,13561,13561,0,115.00768420585231,0.0
1681,13562,13565,3,241.89570313551198,0.1
1682,13566,13566,0,116.68398473704816,0.0
1683,13567,13570,3,252.28466785350784,0.1
1684,13571,13571,0,116.58645979496863,0.0
1685,13574,13575,1,227.25564224094845,0.03333333333333333
1686,13578,13579,1,121.04063875222698,0.03333333333333333
1687,13580,13583,3,247.12829621927563,0.1
1688,13584,13596,12,389.26474941473833,0.4
1689,13597,13597,0,233.38939971764043,0.0
1690,13598,13602,4,348.1128803300422,0.13333333333333333
1691,13603,13609,6,235.02578081085178,0.2
1692,13610,13610,0,431.5173381404814,0.0
1693,13611,13611,0,321.73788409091935,0.0
1694,13612,13615,3,393.5356175795713,0.1
1695,13616,13635,19,204.0053180691056,0.6333333333333333
1696,13636,13642,6,408.9063308091314,0.2
1697,13643,13654,11,525.826268038221,0.36666666666666664
1698,13655,13655,0,121.23071742550295,0.0
1699,13657,13657,0,409.63731467690263,0.0
1700,13658,13659,1,529.151059527844,0.03333333333333333
1701,13660,13661,1,330.59132555397423,0.03333333333333333
1702,13663,13663,0,147.35739932758057,0.0
1703,13664,13664,0,410.16277820486965,0.0
1704,13665,13665,0,559.3639412699489,0.0
1705,13666,13667,1,154.4968607027439,0.03333333333333333
1706,13669,13694,25,231.42376944287625,0.8333333333333334
1707,13701,13704,3,510.5066942117306,0.1
1708,13705,13705,0,405.56143454096565,0.0
1709,13706,13710,4,448.6494288595071,0.13333333333333333
1710,13711,13711,0,126.41898258620775,0.0
1711,13712,13712,0,395.99592411563486,0.0
1712,13713,13713,0,501.488146140868,0.0
1713,13714,13718,4,388.26045220873846,0.13333333333333333
1714,13719,13719,0,123.30581251258496,0.0
1715,13720,13723,3,493.4850886195348,0.1
1716,13724,13724,0,127.87779420253639,0.0
1717,13725,13730,5,434.8215171119119,0.16666666666666666
1718,13731,13731,0,526.1629774881494,0.0
1719,13732,13732,0,419.33868651976655,0.0
1720,13733,13742,9,541.9716595855709,0.3
1721,13743,13753,10,417.13986152511336,0.3333333333333333
1722,13754,13756,2,523.5531334966583,0.06666666666666667
1723,13757,13757,0,361.22866825772184,0.0
1724,13758,13760,2,396.8793025861997,0.06666666666666667
1725,13761,13762,1,506.14449395445473,0.03333333333333333
1726,13763,13785,22,405.0571684566171,0.7333333333333333
1727,13786,13786,0,496.57014372790974,0.0
1728,13787,13789,2,343.49948160947173,0.06666666666666667
1729,13790,13790,0,261.3453255539603,0.0
1730,13791,13792,1,482.1401653394395,0.03333333333333333
1731,13793,13795,2,308.493212938148,0.06666666666666667
1732,13796,13810,14,390.9711021555441,0.4666666666666667
1733,13811,13811,0,184.71843406738554,0.0
1734,13812,13818,6,521.9821514437284,0.2
1735,13819,13822,3,744.7497770647469,0.1
1736,13823,13823,0,548.3960210248467,0.0
1737,13824,13831,7,421.17765145791316,0.23333333333333334
1738,13832,13832,0,600.6266904483267,0.0
1739,13833,13839,6,477.6525846465432,0.2
1740,13840,13853,13,546.856263717555,0.43333333333333335
1741,13854,13854,0,504.519205771855,0.0
1742,13855,13885,30,477.8294525274589,1.0
1743,13886,13905,19,386.34755869364005,0.6333333333333333
1744,13906,13945,39,244.21667407944224,1.3
1745,13946,13950,4,315.1976575014979,0.13333333333333333
1746,13951,13951,0,125.74815177913395,0.0
1747,13952,13952,0,431.07883566319845,0.0
1748,13953,13953,0,144.04000884273302,0.0
1749,13954,13957,3,471.9230178527452,0.1
1750,13958,13959,1,589.5767170136421,0.03333333333333333
1751,13960,13967,7,501.7393451475947,0.23333333333333334
1752,13968,13969,1,636.5505610621346,0.03333333333333333
1753,13970,13973,3,474.8451077018913,0.1
1754,13974,13974,0,212.58137735184386,0.0
1755,13975,13979,4,249.3538471727126,0.13333333333333333
1756,13980,13980,0,300.83256708142767,0.0
1757,13981,13981,0,177.4843576477737,0.0
1758,13982,13982,0,392.78831272602014,0.0
1759,13983,13983,0,503.72889218276214,0.0
1760,13984,13984,0,394.47992428694545,0.0
1761,13985,13987,2,252.32115126894894,0.06666666666666667
1762,13988,13988,0,454.99664742216584,0.0
1763,13989,13993,4,195.73933666251293,0.13333333333333333
1764,13994,13996,2,366.7270337855745,0.06666666666666667
1765,13997,13997,0,179.07399248626993,0.0
1766,13998,13998,0,444.83649536167036,0.0
1767,13999,14002,3,340.57078577629085,0.1
1768,14003,14003,0,181.6360217891655,0.0
1769,14004,14006,2,437.0613463521218,0.06666666666666667
1770,14007,14007,0,297.57319972467053,0.0
1771,14008,14008,0,433.9474647612032,0.0
1772,14009,14012,3,310.2789668775624,0.1
1773,14013,14014,1,187.80119834889462,0.03333333333333333
1774,14015,14015,0,430.0830577282948,0.0
1775,14016,14020,4,264.65442953245525,0.13333333333333333
1776,14021,14023,2,431.7905107514335,0.06666666666666667
1777,14024,14026,2,311.9213836599295,0.06666666666666667
1778,14027,14028,1,467.15602081141327,0.03333333333333333
1779,14029,14029,0,189.07382231474222,0.0
1780,14030,14033,3,242.96696309571936,0.1
1781,14034,14036,2,331.43848888243616,0.06666666666666667
1782,14037,14041,4,214.44819589516456,0.13333333333333333
1783,14042,14045,3,307.07193552975946,0.1
1784,14046,14046,0,166.71472368034162,0.0
1785,14048,14049,1,649.0846075954213,0.03333333333333333
1786,14050,14050,0,481.5938074451499,0.0
1787,14051,14051,0,650.4221270318851,0.0
1788,14052,14057,5,373.9345595667121,0.16666666666666666
1789,14058,14058,0,187.8926428523,0.0
1790,14059,14068,9,458.0831850461565,0.3
1791,14069,14069,0,383.9682922952233,0.0
1792,14070,14070,0,213.43478345239893,0.0
1793,14071,14072,1,468.1084710712846,0.03333333333333333
1794,14073,14077,4,365.02874608436997,0.13333333333333333
1795,14078,14086,8,224.0613007475135,0.26666666666666666
1796,14087,14090,3,316.0788092962871,0.1
1797,14091,14093,2,110.68733231096832,0.06666666666666667
1798,14094,14109,15,253.74175631470072,0.5
1799,14110,14145,35,261.39083302103325,1.1666666666666667
1800,14146,14148,2,308.4450527205442,0.06666666666666667
1801,14149,14163,14,161.358169530827,0.4666666666666667
1802,14164,14164,0,350.74925556134144,0.0
1803,14165,14195,30,259.15432981888466,1.0
1804,14196,14196,0,181.4905382097393,0.0
1805,14197,14208,11,281.13770357561305,0.36666666666666664
1806,14209,14209,0,419.28899919206845,0.0
1807,14211,14221,10,409.59943285247084,0.3333333333333333
1808,14224,14224,0,504.6279161435315,0.0
1809,14225,14234,9,306.495738546702,0.3
1810,14235,14237,2,444.21721164613365,0.06666666666666667
1811,14238,14242,4,298.2463083510509,0.13333333333333333
1812,14243,14243,0,443.5092166750225,0.0
1813,14244,14245,1,541.8683015679358,0.03333333333333333
1814,14246,14246,0,93.96148703858583,0.0
1815,14248,14251,3,505.0452631381771,0.1
1816,14252,14252,0,394.25208262803324,0.0
1817,14253,14253,0,200.98390591530762,0.0
1818,14254,14257,3,403.6200057875262,0.1
1819,14258,14259,1,148.68175922878405,0.03333333333333333
1820,14260,14265,5,370.16790237314666,0.16666666666666666
1821,14266,14266,0,161.1573660148138,0.0
1822,14267,14274,7,471.91138386214493,0.23333333333333334
1823,14275,14277,2,381.54749263121795,0.06666666666666667
1824,14278,14279,1,491.09675923061513,0.03333333333333333
1825,14281,14281,0,153.40345909152094,0.0
1826,14282,14286,4,454.54987026143846,0.13333333333333333
1827,14287,14287,0,162.0046221077971,0.0
1828,14291,14293,2,314.45788609954906,0.06666666666666667
1829,14294,14296,2,140.51346501658514,0.06666666666666667
1830,14297,14297,0,438.60178184598226,0.0
1831,14302,14305,3,56.020907399391156,0.1
1832,14311,14311,0,408.3021370957192,0.0
1833,14316,14316,0,162.58041538580287,0.0
1834,14325,14325,0,456.86499009015597,0.0
1835,14326,14328,2,62.179001962102625,0.06666666666666667
1836,14329,14329,0,368.3194156613156,0.0
1837,14330,14330,0,70.8158536453227,0.0
1838,14331,14334,3,188.95757310778708,0.1
1839,14335,14335,0,373.35403980526297,0.0
1840,14336,14345,9,116.33963128441874,0.3
1841,14346,14346,0,414.28815251108426,0.0
1842,14347,14348,1,124.56243984719538,0.03333333333333333
1843,14351,14357,6,339.2914806784321,0.2
1844,14359,14368,9,168.7997129433494,0.3
1845,14369,14369,0,362.04263632848733,0.0
1846,14378,14378,0,35.6116629891686,0.0
1847,14385,14395,10,279.96638972502603,0.3333333333333333
1848,14396,14396,0,446.30881623135775,0.0
1849,14397,14397,0,292.3154347237078,0.0
1850,14453,14464,11,292.5225145886462,0.36666666666666664
1851,14485,14485,0,290.2136721227076,0.0
1852,14497,14501,4,517.4256166497914,0.13333333333333333
1853,14511,14511,0,388.42482655459224,0.0
1854,14525,14541,16,113.19574810649694,0.5333333333333333
1855,14542,14546,4,393.1390798480333,0.13333333333333333
1856,14547,14571,24,99.64928969815548,0.8
1857,14588,14631,43,102.41154062721904,1.4333333333333333
1858,14635,14635,0,459.9803649095514,0.0
1859,14636,14711,75,132.78427202263285,2.5
1860,14712,14713,1,407.4214286839254,0.03333333333333333
1861,14714,14715,1,152.78906433207334,0.03333333333333333
1862,14732,14735,3,494.15097861859675,0.1
1863,14738,14738,0,373.89350606447994,0.0
1864,14745,14745,0,484.36156193841265,0.0
1865,14767,14776,9,501.4987387913253,0.3
1866,14826,14828,2,791.2212179529487,0.06666666666666667
1867,14829,14829,0,554.8420738497263,0.0
1868,14830,14843,13,741.1580790857807,0.43333333333333335
1869,14844,14844,0,497.7579972612977,0.0
1870,14845,14862,17,660.8326941272047,0.5666666666666667
1871,14864,14864,0,493.182562317209,0.0
1872,14865,14868,3,130.5543364767011,0.1
1873,14871,14871,0,581.7355316586744,0.0
1874,14875,14881,6,405.2071980734507,0.2
1875,14882,14887,5,521.01126779973,0.16666666666666666
1876,14888,14889,1,338.830561787922,0.03333333333333333
1877,14890,14890,0,537.023177340475,0.0
1878,14891,14892,1,392.59038651633807,0.03333333333333333
1879,14893,14893,0,540.9434407282587,0.0
1880,14895,14895,0,353.0178683956689,0.0
1881,14898,14898,0,122.68012052116006,0.0
1882,14899,14901,2,324.36902708611836,0.06666666666666667
1883,14904,14910,6,496.3609852562135,0.2
1884,14911,14911,0,210.50013950000312,0.0
1885,14912,14914,2,307.8234129916138,0.06666666666666667
1886,14915,14918,3,385.3747588007781,0.1
1887,14919,14919,0,219.2267213830968,0.0
1888,14920,14920,0,396.1246376463292,0.0
1889,14921,14921,0,294.2578485902949,0.0
1890,14922,14922,0,143.93730247716073,0.0
1891,14923,14923,0,287.933729930823,0.0
1892,14924,14927,3,219.476976423878,0.1
1893,14928,14928,0,107.07797348182966,0.0
1894,14929,14929,0,271.0547563328699,0.0
1895,14930,14930,0,170.5442749291134,0.0
1896,14931,14931,0,292.17509258024853,0.0
1897,14932,14990,58,311.4253028282086,1.9333333333333333
1898,14991,15036,45,258.98317268698804,1.5
1899,15037,15037,0,475.00298118740517,0.0
1900,15038,15038,0,269.71283984414595,0.0
1901,15039,15039,0,379.76997943303513,0.0
1902,15040,15040,0,275.98883997629326,0.0
1903,15041,15047,6,438.29249032910496,0.2
1904,15048,15051,3,302.05480125038014,0.1
1905,15052,15052,0,469.04254775934805,0.0
1906,15053,15053,0,331.0660711272343,0.0
1907,15054,15067,13,404.19637392219977,0.43333333333333335
1908,15068,15068,0,505.8240171230418,0.0
1909,15069,15078,9,389.557052166789,0.3
1910,15079,15083,4,221.98728547567208,0.13333333333333333
1911,15084,15084,0,394.68958695945526,0.0
1912,15085,15085,0,223.57481657486417,0.0
1913,15086,15086,0,395.2804291743526,0.0
1914,15087,15089,2,196.7755348546913,0.06666666666666667
1915,15090,15093,3,393.59506580360863,0.1
1916,15094,15095,1,198.86239809485488,0.03333333333333333
1917,15096,15104,8,421.23703504994126,0.26666666666666666
1918,15105,15105,0,168.6024679217669,0.0
1919,15106,15106,0,437.533064708239,0.0
1920,15107,15113,6,167.25685999622524,0.2
1921,15114,15119,5,447.18003436944025,0.16666666666666666
1922,15120,15127,7,500.86502202068334,0.23333333333333334
1923,15133,15134,1,750.6333233329372,0.03333333333333333
1924,15136,15136,0,447.93390034860164,0.0
1925,15147,15154,7,214.52482616512984,0.23333333333333334
1926,15155,15155,0,432.9265985078684,0.0
1927,15156,15157,1,196.62798749109345,0.03333333333333333
1928,15158,15160,2,392.7130964378987,0.06666666666666667
1929,15161,15161,0,192.8281496259248,0.0
1930,15162,15162,0,458.9657412873701,0.0
1931,15163,15175,12,199.87006493453464,0.4
1932,15176,15178,2,421.82210002143984,0.06666666666666667
1933,15179,15179,0,181.35505015058754,0.0
1934,15180,15187,7,388.4466268827358,0.23333333333333334
1935,15188,15188,0,228.2527451050654,0.0
1936,15189,15197,8,399.4902964092755,0.26666666666666666
1937,15200,15200,0,122.09224906777466,0.0
1938,15202,15202,0,443.13605471187316,0.0
1939,15203,15204,1,140.0544670885905,0.03333333333333333
1940,15205,15206,1,500.83227299763155,0.03333333333333333
1941,15207,15210,3,405.58322693842916,0.1
1942,15211,15215,4,145.49250161077833,0.13333333333333333
1943,15216,15216,0,400.0450897598659,0.0
1944,15217,15219,2,142.87513547272326,0.06666666666666667
1945,15220,15220,0,380.36983403148287,0.0
1946,15221,15221,0,160.5697545964011,0.0
1947,15222,15223,1,388.43563543929815,0.03333333333333333
1948,15224,15237,13,462.76780437133164,0.43333333333333335
1949,15240,15251,11,141.30826530115195,0.36666666666666664
1950,15254,15254,0,441.86051412935507,0.0
1951,15256,15261,5,358.3656001983087,0.16666666666666666
1952,15265,15266,1,105.64569672643889,0.03333333333333333
1953,15267,15267,0,410.1772727369416,0.0
1954,15269,15270,1,105.39461330481842,0.03333333333333333
1955,15271,15271,0,341.9227399706795,0.0
1956,15272,15273,1,122.3105418806965,0.03333333333333333
1957,15277,15278,1,185.52552177057936,0.03333333333333333
1958,15281,15289,8,547.1461864684362,0.26666666666666666
1959,15290,15292,2,253.00183637755495,0.06666666666666667
1960,15293,15293,0,383.8751790050472,0.0
1961,15294,15296,2,227.24789523856018,0.06666666666666667
1962,15297,15317,20,490.0609714659348,0.6666666666666666
1963,15318,15344,26,294.46289738760845,0.8666666666666667
1964,15345,15345,0,495.1963558168057,0.0
1965,15346,15346,0,362.5109178593336,0.0
1966,15349,15356,7,475.5918085080534,0.23333333333333334
1967,15357,15371,14,585.8812456831527,0.4666666666666667
1968,15372,15372,0,316.7577501325558,0.0
1969,15373,15384,11,449.48007568107664,0.36666666666666664
1970,15385,15389,4,310.6822503050218,0.13333333333333333
1971,15391,15391,0,438.01963433766457,0.0
1972,15392,15392,0,196.8371222485149,0.0
1973,15393,15393,0,466.6503808014231,0.0
1974,15399,15406,7,73.90422021537532,0.23333333333333334
1975,15407,15411,4,553.7297458598755,0.13333333333333333
1976,15412,15412,0,396.2917564942311,0.0
1977,15413,15413,0,689.8650201485395,0.0
1978,15414,15416,2,566.7120194339632,0.06666666666666667
1979,15417,15417,0,365.7321692725982,0.0
1980,15418,15418,0,86.78016970934837,0.0
1981,15419,15423,4,333.3759479174433,0.13333333333333333
1982,15424,15424,0,97.5371672994698,0.0
1983,15427,15428,1,496.6979117159467,0.03333333333333333
1984,15429,15438,9,300.2811285991709,0.3
1985,15439,15441,2,332.3470022454773,0.06666666666666667
1986,15442,15444,2,397.52778663491176,0.06666666666666667
1987,15446,15446,0,502.06462124823236,0.0
1988,15447,15447,0,389.6445095490828,0.0
1989,15448,15449,1,133.31291980439073,0.03333333333333333
1990,15457,15464,7,429.41028966321795,0.23333333333333334
1991,15474,15474,0,318.1199952310646,0.0
1992,15479,15481,2,79.18131455658495,0.06666666666666667
1993,15487,15503,16,187.97132923060352,0.5333333333333333
1994,15505,15508,3,317.31584243359396,0.1
1995,15509,15522,13,246.1337154648327,0.43333333333333335
1996,15524,15525,1,237.3613533797626,0.03333333333333333
1997,15526,15539,13,235.87285672603053,0.43333333333333335
1998,15552,15552,0,462.081186761036,0.0
1999,15553,15553,0,334.2947893013438,0.0
2000,15554,15554,0,173.73238769449327,0.0
2001,15555,15555,0,302.5906130438863,0.0
2002,15556,15556,0,107.99121261888884,0.0
2003,15560,15578,18,249.26205634640127,0.6
2004,15582,15596,14,513.4991893198037,0.4666666666666667
2005,15598,15601,3,224.17207760915488,0.1
2006,15602,15602,0,143.06137243342218,0.0
2007,15603,15605,2,388.2735717566904,0.06666666666666667
2008,15606,15607,1,185.76352187053106,0.03333333333333333
2009,15608,15608,0,550.3456905168891,0.0
2010,15609,15613,4,358.9476910374636,0.13333333333333333
2011,15614,15616,2,411.16787521257874,0.06666666666666667
2012,15617,15618,1,563.5495817253283,0.03333333333333333
2013,15619,15634,15,203.63012249441664,0.5
2014,15635,15635,0,343.5594797266995,0.0
2015,15636,15640,4,237.63392355628721,0.13333333333333333
2016,15641,15645,4,232.14021479644953,0.13333333333333333
2017,15646,15646,0,160.0864856974224,0.0
2018,15647,15648,1,355.88357535450587,0.03333333333333333
2019,15649,15651,2,165.93223824477155,0.06666666666666667
2020,15652,15652,0,356.4205281197078,0.0
2021,15653,15653,0,173.08950970735592,0.0
2022,15654,15658,4,387.69913490280544,0.13333333333333333
2023,15659,15659,0,242.88220116148557,0.0
2024,15660,15676,16,328.6729504869731,0.5333333333333333
2025,15677,15677,0,508.64931480405494,0.0
2026,15678,15680,2,395.5493654338646,0.06666666666666667
2027,15681,15681,0,529.0837619534622,0.0
2028,15682,15684,2,365.6156629879818,0.06666666666666667
2029,15685,15692,7,303.8688613493073,0.23333333333333334
2030,15693,15694,1,167.00117513483912,0.03333333333333333
2031,15695,15695,0,317.1140663848446,0.0
2032,15696,15696,0,137.93844392484877,0.0
2033,15697,15698,1,351.2297404033685,0.03333333333333333
2034,15699,15700,1,215.81494944607226,0.03333333333333333
2035,15701,15702,1,137.407851268328,0.03333333333333333
2036,15703,15703,0,295.4493627359563,0.0
2037,15704,15706,2,193.58949826281568,0.06666666666666667
2038,15709,15716,7,244.73785338819667,0.23333333333333334
2039,15718,15718,0,151.92243782338912,0.0
2040,15719,15740,21,326.327564273299,0.7
2041,15743,15743,0,74.16124895536788,0.0
2042,15744,15754,10,339.92594093249744,0.3333333333333333
2043,15757,15758,1,293.7407935029229,0.03333333333333333
2044,15764,15774,10,190.5114262610774,0.3333333333333333
2045,15775,15775,0,364.1700108269745,0.0
2046,15776,15782,6,311.2060733962136,0.2
2047,15783,15785,2,247.45616996477324,0.06666666666666667
2048,15786,15787,1,410.15429800478853,0.03333333333333333
2049,15788,15791,3,242.2577446310984,0.1
2050,15793,15799,6,404.0823147019464,0.2
2051,15800,15806,6,212.26148927905598,0.2
2052,15809,15809,0,573.6933628710481,0.0
2053,15810,15824,14,385.1046829963198,0.4666666666666667
2054,15825,15825,0,600.0008418483666,0.0
2055,15826,15827,1,460.6885429299929,0.03333333333333333
2056,15828,15828,0,201.69550977867738,0.0
2057,15829,15829,0,598.6647571145587,0.0
2058,15831,15850,19,214.8006817278126,0.6333333333333333
2059,15851,15855,4,377.67053558467217,0.13333333333333333
2060,15856,15859,3,434.45075686062637,0.1
2061,15860,15861,1,347.65721535795467,0.03333333333333333
2062,15862,15886,24,350.75385727595943,0.8
2063,15887,15887,0,229.7300767794752,0.0
2064,15888,15888,0,406.03001475403994,0.0
2065,15889,15889,0,227.65286187983534,0.0
2066,15890,15926,36,423.97705322728524,1.2
2067,15927,15927,0,532.0239402854788,0.0
2068,15928,15937,9,447.7782126498926,0.3
2069,15938,15938,0,149.03043481653685,0.0
2070,15939,15954,15,409.65994013135264,0.5
2071,15955,15959,4,398.3954076487998,0.13333333333333333
2072,15960,15960,0,523.1549389176081,0.0
2073,15961,15961,0,400.9456629015572,0.0
2074,15962,15962,0,519.3501280260363,0.0
2075,15963,15963,0,311.8687177515697,0.0
2076,15964,15974,10,462.9708478303,0.3333333333333333
2077,15975,15978,3,499.7564570844695,0.1
2078,15979,15981,2,565.9645588490458,0.06666666666666667
2079,15982,15984,2,455.3004089080844,0.06666666666666667
2080,15985,15985,0,322.1248743408904,0.0
2081,15987,15987,0,83.33379439309253,0.0
2082,15988,15998,10,253.74594633363213,0.3333333333333333
2083,15999,16012,13,207.73135202673583,0.43333333333333335
2084,16013,16016,3,347.1462205809797,0.1
2085,16017,16018,1,227.86000533716657,0.03333333333333333
2086,16019,16019,0,339.84864736842627,0.0
2087,16020,16020,0,223.71988175091488,0.0
2088,16021,16032,11,325.9897841065506,0.36666666666666664
2089,16033,16033,0,73.2059360179095,0.0
2090,16034,16034,0,349.7997096979004,0.0
2091,16035,16035,0,187.58364325687026,0.0
2092,16036,16040,4,289.7708490384234,0.13333333333333333
2093,16041,16041,0,137.34608958957543,0.0
2094,16042,16049,7,332.44613423827286,0.23333333333333334
2095,16050,16050,0,105.58897685776783,0.0
2096,16051,16078,27,262.0139792146377,0.9
2097,16079,16079,0,446.47648285329655,0.0
2098,16080,16080,0,330.64317734054197,0.0
2099,16081,16081,0,442.6423658273189,0.0
2100,16082,16082,0,249.81486424150418,0.0
2101,16083,16084,1,439.7409200025512,0.03333333333333333
2102,16085,16085,0,316.9190749587997,0.0
2103,16086,16086,0,429.7332919733764,0.0
2104,16087,16088,1,294.97031588371294,0.03333333333333333
2105,16089,16092,3,403.99215984739135,0.1
2106,16093,16095,2,284.234646571413,0.06666666666666667
2107,16096,16096,0,83.68834642198347,0.0
2108,16098,16107,9,294.29285914241166,0.3
2109,16110,16112,2,39.866257035040285,0.06666666666666667
2110,16131,16132,1,180.80820157773962,0.03333333333333333
2111,16134,16134,0,308.10446388862755,0.0
2112,16135,16136,1,573.575407434759,0.03333333333333333
2113,16137,16138,1,411.98259989000735,0.03333333333333333
2114,16139,16141,2,635.3180330265718,0.06666666666666667
2115,16143,16149,6,254.28612727402594,0.2
2116,16151,16151,0,213.58556914364655,0.0
2117,16152,16158,6,312.25429367887943,0.2
2118,16163,16167,4,530.0909364710326,0.13333333333333333
2119,16168,16172,4,471.3480946179546,0.13333333333333333
2120,16173,16174,1,535.0840733056351,0.03333333333333333
2121,16175,16175,0,295.08707537530603,0.0
2122,16176,16182,6,331.51273070055646,0.2
2123,16187,16187,0,522.0421285675591,0.0
2124,16188,16190,2,408.3871092868185,0.06666666666666667
2125,16191,16205,14,249.84696367775229,0.4666666666666667
2126,16207,16209,2,464.93304567673914,0.06666666666666667
2127,16210,16214,4,411.6225981456113,0.13333333333333333
2128,16215,16218,3,240.40385913327705,0.1
2129,16219,16219,0,444.31909020807643,0.0
2130,16220,16220,0,250.57136101237967,0.0
2131,16221,16228,7,483.94456877898165,0.23333333333333334
2132,16229,16229,0,614.0225580405439,0.0
2133,16230,16240,10,505.94843075673367,0.3333333333333333
2134,16241,16241,0,601.3535009134384,0.0
2135,16242,16242,0,359.1221754099722,0.0
2136,16243,16243,0,105.7686139919867,0.0
2137,16244,16245,1,339.1514861294263,0.03333333333333333
2138,16246,16246,0,146.61492203738743,0.0
2139,16248,16248,0,412.89668193574914,0.0
2140,16249,16249,0,144.36772204316193,0.0
2141,16250,16250,0,757.5372459638335,0.0
2142,16251,16256,5,494.4301269384794,0.16666666666666666
2143,16257,16278,21,382.773115478428,0.7
2144,16279,16280,1,296.58115819865384,0.03333333333333333
2145,16281,16281,0,421.7613201865993,0.0
2146,16282,16290,8,287.294223820607,0.26666666666666666
2147,16291,16291,0,162.50057514840773,0.0
2148,16295,16298,3,319.0773204108897,0.1
2149,16299,16299,0,567.4012287903724,0.0
2150,16300,16301,1,343.59217299900536,0.03333333333333333
2151,16302,16302,0,544.3314292191305,0.0
2152,16303,16304,1,407.50081802248343,0.03333333333333333
2153,16305,16307,2,508.70882300581394,0.06666666666666667
2154,16308,16318,10,362.75816335542197,0.3333333333333333
2155,16319,16319,0,478.7563510002383,0.0
2156,16320,16337,17,393.3008506691352,0.5666666666666667
2157,16338,16338,0,558.5833187427215,0.0
2158,16339,16342,3,364.3862811977614,0.1
2159,16343,16350,7,407.53152626977646,0.23333333333333334
2160,16351,16353,2,214.46224486070938,0.06666666666666667
2161,16372,16373,1,190.65775777195233,0.03333333333333333
2162,16375,16375,0,592.3491695241386,0.0
2163,16384,16384,0,475.40153267569445,0.0
2164,16385,16388,3,32.06113717484875,0.1
2165,16390,16390,0,394.5276664073877,0.0
2166,16391,16391,0,35.712969592497934,0.0
2167,16418,16420,2,159.58626025370447,0.06666666666666667
2168,16421,16421,0,248.82209063168412,0.0
2169,16423,16440,17,118.11320401029414,0.5666666666666667
2170,16447,16447,0,372.12124641670886,0.0
2171,16448,16461,13,181.14178208012189,0.43333333333333335
2172,16463,16464,1,317.8322727615935,0.03333333333333333
2173,16466,16467,1,143.82067739584315,0.03333333333333333
2174,16475,16480,5,261.03515613822884,0.16666666666666666
2175,16486,16488,2,144.14139154865654,0.06666666666666667
2176,16489,16504,15,291.94541856025523,0.5
2177,16505,16505,0,168.5413235868896,0.0
2178,16506,16508,2,338.7071186991088,0.06666666666666667
2179,16509,16509,0,422.09847560335544,0.0
2180,16510,16510,0,291.5471534341208,0.0
2181,16511,16511,0,454.8862905972799,0.0
2182,16512,16512,0,161.30579818729157,0.0
2183,16514,16514,0,312.2482209257834,0.0
2184,16515,16515,0,440.28959023412574,0.0
2185,16518,16520,2,178.9934531097582,0.06666666666666667
2186,16524,16532,8,353.9498694020662,0.26666666666666666
2187,16533,16538,5,382.4366674050743,0.16666666666666666
2188,16539,16539,0,538.7587940827068,0.0
2189,16540,16540,0,329.50851554730593,0.0
2190,16542,16542,0,162.0177710419326,0.0
2191,16543,16543,0,525.6454391547302,0.0
2192,16545,16545,0,184.6804515184047,0.0
2193,16546,16552,6,352.16039109232725,0.2
2194,16554,16554,0,124.46451626969076,0.0
2195,16555,16557,2,390.47575770154936,0.06666666666666667
2196,16558,16558,0,125.13085579424535,0.0
2197,16559,16569,10,385.24839930255246,0.3333333333333333
2198,16572,16572,0,253.4853833184295,0.0
2199,16573,16590,17,498.80906419296053,0.5666666666666667
2200,16591,16591,0,441.08324756357774,0.0
2201,16592,16605,13,515.9560822322787,0.43333333333333335
2202,16606,16608,2,593.5354744223778,0.06666666666666667
2203,16609,16638,29,514.3626281609406,0.9666666666666667
2204,16639,16668,29,359.17857929231934,0.9666666666666667
2205,16669,16679,10,413.86287565761126,0.3333333333333333
2206,16732,16735,3,141.81825967784627,0.1
2207,16736,16736,0,394.7427405207431,0.0
2208,16737,16739,2,161.39018930920236,0.06666666666666667
2209,16748,16750,2,456.97906304857764,0.06666666666666667
2210,16751,16752,1,499.2407878827362,0.03333333333333333
2211,16753,16753,0,165.87229303813066,0.0
2212,16754,16754,0,382.0817169071718,0.0
2213,16755,16755,0,81.11980561129633,0.0
2214,16757,16757,0,376.8834669229433,0.0
2215,16758,16758,0,152.94135348462862,0.0
2216,16759,16765,6,374.42358008249255,0.2
2217,16766,16766,0,465.1950382903686,0.0
2218,16773,16798,25,172.41833344828024,0.8333333333333334
2219,16800,16800,0,359.0282554438357,0.0
2220,16801,16801,0,233.2163546300845,0.0
2221,16802,16805,3,282.98347391001766,0.1
2222,16807,16809,2,98.712495657655,0.06666666666666667
2223,16810,16810,0,230.74962952936775,0.0
2224,16811,16812,1,77.88686564146046,0.03333333333333333
2225,16817,16820,3,314.86668347339764,0.1
2226,16822,16826,4,90.52415800193299,0.13333333333333333
2227,16828,16832,4,310.3517206873057,0.13333333333333333
2228,16833,16834,1,142.9437286713557,0.03333333333333333
2229,16835,16835,0,277.00100558756236,0.0
2230,16836,16839,3,102.39154696307368,0.1
2231,16840,16844,4,252.534707336399,0.13333333333333333
2232,16845,16845,0,150.89163513742085,0.0
2233,16846,16870,24,358.5685389251435,0.8
2234,16871,16871,0,399.94530815804274,0.0
2235,16872,16873,1,190.3497730583193,0.03333333333333333
2236,16874,16886,12,390.26057446886324,0.4
2237,16887,16887,0,240.6923657931579,0.0
2238,16888,16894,6,381.16768158920866,0.2
2239,16895,16897,2,259.61072289650593,0.06666666666666667
2240,16898,16903,5,351.70126955176846,0.16666666666666666
2241,16904,16909,5,426.736671795116,0.16666666666666666
2242,16910,16916,6,341.6953505723494,0.2
2243,16918,16918,0,468.8964402064347,0.0
2244,16919,16924,5,399.7346078381914,0.16666666666666666
2245,16925,16925,0,195.4215586636167,0.0
2246,16926,16928,2,365.8697465998219,0.06666666666666667
2247,16929,16929,0,98.82518215134347,0.0
2248,16931,16934,3,492.50109792105235,0.1
2249,16938,16938,0,38.51609100537507,0.0
2250,16943,16959,16,242.74397121589888,0.5333333333333333
2251,16960,16976,16,225.97037096749793,0.5333333333333333
2252,16977,16977,0,141.36293780406302,0.0
2253,16978,16980,2,267.19993948378453,0.06666666666666667
2254,16981,16985,4,467.12560018185366,0.13333333333333333
2255,16987,16991,4,304.94457100518196,0.13333333333333333
2256,16999,16999,0,402.0740896692308,0.0
2257,17000,17003,3,303.3523276141446,0.1
2258,17004,17004,0,459.69654392698516,0.0
2259,17005,17005,0,566.7336638150116,0.0
2260,17006,17008,2,307.976346208015,0.06666666666666667
2261,17009,17009,0,519.6492617017124,0.0
2262,17010,17014,4,321.7360171603898,0.13333333333333333
2263,17015,17015,0,247.35633015282474,0.0
2264,17016,17019,3,383.8153873946537,0.1
2265,17020,17020,0,272.01966641151597,0.0
2266,17021,17063,42,382.7907380076496,1.4
2267,17064,17064,0,236.7112120496794,0.0
2268,17065,17165,100,352.19531287654587,3.3333333333333335
2269,17166,17166,0,204.786626672008,0.0
2270,17167,17193,26,327.45402525611166,0.8666666666666667
2271,17194,17253,59,387.0132713861022,1.9666666666666666
2272,17255,17255,0,199.59782908128517,0.0
2273,17256,17256,0,530.1290800703234,0.0
2274,17257,17259,2,378.86437422969175,0.06666666666666667
2275,17263,17275,12,99.94337763803985,0.4
2276,17287,17288,1,272.89119365798354,0.03333333333333333
2277,17304,17313,9,289.63918730327,0.3
2278,17314,17314,0,475.7448093937204,0.0
2279,17315,17315,0,269.1941057223421,0.0
2280,17316,17316,0,478.63859358394177,0.0
2281,17317,17317,0,368.7148198265382,0.0
2282,17318,17319,1,480.3683750349858,0.03333333333333333
2283,17320,17326,6,422.989891828643,0.2
2284,17327,17329,2,520.7256328672834,0.06666666666666667
2285,17330,17342,12,505.3872373053285,0.4
2286,17343,17344,1,544.9099440303678,0.03333333333333333
2287,17345,17384,39,429.76434972594444,1.3
2288,17385,17385,0,468.0068711816856,0.0
2289,17386,17399,13,567.0604547683535,0.43333333333333335
2290,17400,17401,1,729.3627685201412,0.03333333333333333
2291,17402,17405,3,460.7128263287939,0.1
2292,17406,17447,41,386.47232988993585,1.3666666666666667
2293,17448,17462,14,296.5464447235448,0.4666666666666667
2294,17463,17472,9,454.8984457799106,0.3
2295,17473,17477,4,467.7128152277443,0.13333333333333333
2296,17478,17478,0,590.2408377928323,0.0
2297,17479,17494,15,470.42633204710114,0.5
2298,17495,17503,8,490.69934005973147,0.26666666666666666
2299,17504,17504,0,306.46253090187423,0.0
2300,17505,17512,7,493.0301379593507,0.23333333333333334
2301,17513,17513,0,296.9416368056615,0.0
2302,17514,17515,1,492.3449318171656,0.03333333333333333
2303,17516,17529,13,306.5783004764272,0.43333333333333335
2304,17530,17536,6,544.4054465811025,0.2
2305,17537,17537,0,684.1176238205966,0.0
2306,17538,17548,10,343.4681766781291,0.3333333333333333
2307,17550,17551,1,520.691232842069,0.03333333333333333
2308,17553,17556,3,89.94286681088528,0.1
2309,17557,17567,10,381.08492973002683,0.3333333333333333
2310,17568,17571,3,259.93764253535994,0.1
2311,17572,17572,0,185.3763420931361,0.0
2312,17573,17576,3,392.7194327402969,0.1
2313,17577,17577,0,475.53374128898395,0.0
2314,17578,17580,2,410.7384755878649,0.06666666666666667
2315,17581,17582,1,282.87211111297665,0.03333333333333333
2316,17583,17583,0,452.81234387863014,0.0
2317,17584,17587,3,306.9956228592989,0.1
2318,17588,17588,0,509.4972326192653,0.0
2319,17589,17590,1,373.6397068453357,0.03333333333333333
2320,17591,17595,4,498.61617705758863,0.13333333333333333
2321,17597,17598,1,382.3403605143026,0.03333333333333333
2322,17599,17599,0,506.1165420934337,0.0
2323,17600,17612,12,436.8401517281246,0.4
2324,17613,17613,0,218.66261665606467,0.0
2325,17614,17614,0,477.79666871849105,0.0
2326,17615,17618,3,605.1318250339149,0.1
2327,17619,17619,0,223.53767273592788,0.0
2328,17620,17623,3,563.2069647084387,0.1
2329,17624,17626,2,373.63643157255086,0.06666666666666667
2330,17627,17629,2,604.301525958144,0.06666666666666667
2331,17630,17630,0,486.2903208726709,0.0
2332,17631,17631,0,594.7799037853428,0.0
2333,17632,17632,0,258.6710010703471,0.0
2334,17633,17633,0,612.9517905747955,0.0
2335,17634,17638,4,265.1317177279482,0.13333333333333333
2336,17639,17639,0,361.79371688685774,0.0
2337,17640,17651,11,485.89037957624413,0.36666666666666664
2338,17652,17658,6,505.15222033862307,0.2
2339,17659,17659,0,274.84367600698044,0.0
2340,17660,17661,1,441.6148800688069,0.03333333333333333
2341,17662,17663,1,207.57303461188724,0.03333333333333333
2342,17664,17670,6,93.5795762333802,0.2
2343,17671,17675,4,150.61167729007784,0.13333333333333333
2344,17676,17676,0,326.74406835100126,0.0
2345,17677,17678,1,177.1748884605591,0.03333333333333333
2346,17679,17692,13,412.4091846386442,0.43333333333333335
2347,17693,17695,2,410.62666062464785,0.06666666666666667
2348,17699,17701,2,218.79205562864007,0.06666666666666667
2349,17702,17720,18,368.227706751288,0.6
2350,17721,17721,0,473.4445556915721,0.0
2351,17722,17723,1,335.3962788545598,0.03333333333333333
2352,17724,17775,51,306.3655514142288,1.7
2353,17776,17776,0,397.4233726207258,0.0
2354,17777,17788,11,310.422450756228,0.36666666666666664
2355,17789,17789,0,195.50994979097564,0.0
2356,17790,17798,8,353.69988497000236,0.26666666666666666
2357,17799,17809,10,197.07903833013532,0.3333333333333333
2358,17810,17830,20,246.66925844255422,0.6666666666666666
2359,17831,17832,1,415.65780660701205,0.03333333333333333
2360,17833,17836,3,239.27899037716017,0.1
2361,17837,17840,3,422.32128193206523,0.1
2362,17841,17861,20,317.4340507504637,0.6666666666666666
2363,17862,17862,0,243.4542163645812,0.0
2364,17863,17873,10,276.04525956298335,0.3333333333333333
2365,17874,17877,3,416.4377088922798,0.1
2366,17878,17878,0,239.42340258299905,0.0
2367,17879,17879,0,402.37027474285924,0.0
2368,17880,17883,3,258.1738680236742,0.1
2369,17884,17891,7,279.39729382175705,0.23333333333333334
2370,17892,17896,4,424.1661894713494,0.13333333333333333
2371,17897,17900,3,292.1565671726684,0.1
2372,17901,17901,0,431.5323282842648,0.0
2373,17902,17914,12,304.2290692241301,0.4
2374,17915,17917,2,152.6930599004486,0.06666666666666667
2375,17919,17919,0,470.8448855473835,0.0
2376,17920,17920,0,157.06128035420173,0.0
2377,17921,17927,6,462.6583541087194,0.2
2378,17928,17928,0,171.13857539028626,0.0
2379,17929,17929,0,418.2545767747861,0.0
2380,17930,17936,6,121.2301613902493,0.2
2381,17937,17940,3,280.0597294467417,0.1
2382,17941,17962,21,333.9725568783737,0.7
2383,17963,17963,0,462.58767848275,0.0
2384,17964,17990,26,347.2744312600607,0.8666666666666667
2385,17991,17993,2,496.22335558709193,0.06666666666666667
2386,17995,17995,0,188.61379414795667,0.0
2387,17996,17996,0,512.2862572660297,0.0
2388,17997,17997,0,308.97840258817484,0.0
2389,17998,18001,3,457.47837952741565,0.1
2390,18002,18004,2,581.772722522791,0.06666666666666667
2391,18005,18005,0,368.4614142974881,0.0
2392,18006,18006,0,472.01392762742285,0.0
2393,18007,18007,0,358.3659279970911,0.0
2394,18008,18011,3,208.20691958129083,0.1
2395,18015,18016,1,392.7083517829741,0.03333333333333333
2396,18017,18017,0,230.4813754001581,0.0
2397,18018,18019,1,513.3762785966254,0.03333333333333333
2398,18021,18027,6,244.2886877199302,0.2
2399,18029,18029,0,658.7317833779678,0.0
2400,18032,18032,0,109.43851354892756,0.0
2401,18038,18038,0,482.98796176876914,0.0
2402,18039,18039,0,639.3276527706432,0.0
2403,18040,18041,1,375.2665976280675,0.03333333333333333
2404,18042,18042,0,235.70359178485583,0.0
2405,18047,18048,1,577.8920146294959,0.03333333333333333
2406,18049,18049,0,421.48803144767066,0.0
2407,18050,18050,0,230.01749387333,0.0
2408,18051,18082,31,159.37674065286225,1.0333333333333334
2409,18083,18085,2,283.8119432322233,0.06666666666666667
2410,18086,18089,3,80.64378147835018,0.1
2411,18091,18093,2,324.06861499420285,0.06666666666666667
2412,18094,18102,8,63.526548782882756,0.26666666666666666
2413,18103,18103,0,315.1859715176761,0.0
2414,18104,18115,11,65.85535203650535,0.36666666666666664
2415,18116,18116,0,202.40122158389167,0.0
2416,18117,18156,39,197.7103995572529,1.3
2417,18157,18158,1,303.7705749935793,0.03333333333333333
2418,18159,18175,16,318.33140971742927,0.5333333333333333
2419,18176,18176,0,444.4138005800351,0.0
2420,18177,18177,0,255.1677151145115,0.0
2421,18178,18192,14,333.6933299662598,0.4666666666666667
2422,18193,18197,4,215.89561847388805,0.13333333333333333
2423,18200,18207,7,303.87116044936766,0.23333333333333334
2424,18208,18208,0,172.91829702186047,0.0
2425,18209,18219,10,241.5358822215752,0.3333333333333333
2426,18220,18224,4,259.43383680045565,0.13333333333333333
2427,18225,18237,12,311.19433462076825,0.4
2428,18238,18238,0,489.9054795826244,0.0
2429,18239,18239,0,384.20562306763867,0.0
2430,18240,18245,5,472.71266457989856,0.16666666666666666
2431,18246,18251,5,606.7813373423858,0.16666666666666666
2432,18252,18252,0,464.02400293554143,0.0
2433,18253,18261,8,622.6111490357465,0.26666666666666666
2434,18262,18280,18,374.44050547997807,0.6
2435,18281,18282,1,132.38110748819452,0.03333333333333333
2436,18283,18292,9,331.3774890607789,0.3
2437,18293,18299,6,205.3215627326185,0.2
2438,18300,18306,6,231.71006102560156,0.2
2439,18307,18322,15,260.5659667957208,0.5
2440,18323,18340,17,306.8818820959241,0.5666666666666667
2441,18341,18341,0,166.24029785358513,0.0
2442,18342,18350,8,259.13068542307497,0.26666666666666666
2443,18351,18355,4,346.2562497420513,0.13333333333333333
2444,18356,18369,13,246.76789209654862,0.43333333333333335
2445,18370,18381,11,258.9688039884681,0.36666666666666664
2446,18382,18391,9,290.9029097622411,0.3
2447,18393,18395,2,137.31848179459772,0.06666666666666667
2448,18396,18396,0,313.5495911139355,0.0
2449,18397,18399,2,103.03809931682807,0.06666666666666667
2450,18408,18432,24,217.8108210021635,0.8
2451,18433,18449,16,286.5533668890314,0.5333333333333333
2452,18450,18451,1,421.0642162830484,0.03333333333333333
2453,18452,18452,0,286.7683795423281,0.0
2454,18453,18453,0,425.33687792729233,0.0
2455,18454,18457,3,561.8276249380416,0.1
2456,18458,18465,7,430.08558615217487,0.23333333333333334
2457,18466,18468,2,491.02018470310685,0.06666666666666667
2458,18469,18473,4,399.9955204633081,0.13333333333333333
2459,18474,18475,1,550.1945768459453,0.03333333333333333
2460,18476,18476,0,385.93072875524456,0.0
2461,18477,18480,3,520.8190880357697,0.1
2462,18481,18485,4,489.8301852480339,0.13333333333333333
2463,18486,18488,2,623.710237718203,0.06666666666666667
2464,18490,18503,13,252.1464063101918,0.43333333333333335
2465,18504,18504,0,78.00751667614333,0.0
2466,18505,18509,4,282.12287512276293,0.13333333333333333
2467,18510,18514,4,549.5894023815505,0.13333333333333333
2468,18515,18525,10,219.6795315863511,0.3333333333333333
2469,18526,18538,12,395.67365200824764,0.4
2470,18539,18539,0,206.94544892366255,0.0
2471,18540,18545,5,394.06506231381076,0.16666666666666666
2472,18546,18549,3,504.6997884160053,0.1
2473,18550,18550,0,424.66177519275533,0.0
2474,18551,18554,3,591.1409062186262,0.1
2475,18555,18556,1,269.3562666495149,0.03333333333333333
2476,18557,18558,1,479.01595310191556,0.03333333333333333
2477,18562,18562,0,570.7172718726149,0.0
2478,18570,18570,0,150.15051925887747,0.0
2479,18572,18575,3,371.8434809246141,0.1
2480,18576,18576,0,541.0914378643083,0.0
2481,18577,18577,0,247.09471975673236,0.0
2482,18578,18578,0,539.1565119771547,0.0
2483,18579,18584,5,226.7652868931068,0.16666666666666666
2484,18585,18585,0,126.2007228578668,0.0
2485,18586,18593,7,213.12458157416677,0.23333333333333334
2486,18594,18606,12,119.30350473656081,0.4
2487,18607,18615,8,307.5310233084403,0.26666666666666666
2488,18617,18619,2,108.15604253030882,0.06666666666666667
2489,18620,18620,0,257.24421524959905,0.0
2490,18626,18645,19,164.82064776769863,0.6333333333333333
2491,18646,18647,1,285.43354723917287,0.03333333333333333
2492,18648,18689,41,160.7678389024723,1.3666666666666667
2493,18705,18720,15,256.4520728002636,0.5
2494,18742,18759,17,299.80530157421293,0.5666666666666667
2495,18765,18776,11,122.95032368777328,0.36666666666666664
2496,18803,18829,26,176.7947437658883,0.8666666666666667
2497,18830,18830,0,414.3241269404143,0.0
2498,18831,18831,0,572.8055291211915,0.0
2499,18835,18835,0,204.6341650407188,0.0
2500,18836,18861,25,105.17554459073745,0.8333333333333334
2501,18862,18866,4,584.4202368902608,0.13333333333333333
2502,18868,18868,0,313.86724671966084,0.0
2503,18869,18910,41,157.99364695833611,1.3666666666666667
2504,18913,18913,0,453.04255206983913,0.0
2505,18915,18923,8,241.58219616416787,0.26666666666666666
2506,18941,18941,0,375.4348739194812,0.0
2507,18957,18992,35,108.63741046651647,1.1666666666666667
2508,19015,19028,13,97.99649915360172,0.43333333333333335
2509,19037,19046,9,266.2158509605686,0.3
2510,19047,19047,0,251.34655747749218,0.0
2511,19056,19056,0,52.49441664742758,0.0
2512,19057,19057,0,207.0911833184655,0.0
2513,19058,19063,5,58.66858551301738,0.16666666666666666
2514,19064,19064,0,267.67267737961095,0.0
2515,19065,19065,0,61.49256562292106,0.0
2516,19066,19075,9,250.10065873531892,0.3
2517,19076,19079,3,117.29124071986215,0.1
2518,19080,19080,0,327.78131884369986,0.0
2519,19083,19085,2,125.72867481387246,0.06666666666666667
2520,19086,19088,2,376.725634999605,0.06666666666666667
2521,19089,19089,0,122.94811030514377,0.0
2522,19091,19091,0,406.21017518669345,0.0
2523,19092,19107,15,144.54420505916818,0.5
2524,19126,19143,17,393.89975539885984,0.5666666666666667
2525,19144,19160,16,124.61131157830725,0.5333333333333333
2526,19161,19164,3,385.90519551403605,0.1
2527,19166,19166,0,110.1053600564338,0.0
2528,19168,19169,1,345.68585738111926,0.03333333333333333
2529,19170,19170,0,505.93551532908816,0.0
2530,19175,19186,11,143.19697212531645,0.36666666666666664
2531,19187,19187,0,289.9503096090134,0.0
2532,19188,19207,19,166.17491794621404,0.6333333333333333
2533,19212,19212,0,300.94744008667664,0.0
2534,19220,19222,2,101.7752504804994,0.06666666666666667
2535,19227,19235,8,457.7843539623109,0.26666666666666666
2536,19236,19252,16,214.78716681015487,0.5333333333333333
2537,19253,19255,2,273.4834363031319,0.06666666666666667
2538,19256,19259,3,362.5414293797287,0.1
2539,19260,19266,6,263.692604171298,0.2
2540,19267,19268,1,420.0619668612961,0.03333333333333333
2541,19269,19272,3,333.21574417949665,0.1
2542,19273,19284,11,287.6124560947098,0.36666666666666664
2543,19285,19288,3,418.6489433802355,0.1
2544,19289,19291,2,241.4398653932141,0.06666666666666667
2545,19292,19294,2,410.7809972654154,0.06666666666666667
2546,19295,19301,6,248.81433278035638,0.2
2547,19302,19303,1,530.5589234237307,0.03333333333333333
2548,19304,19305,1,378.57273118770013,0.03333333333333333
2549,19306,19306,0,562.3460953082999,0.0
2550,19307,19309,2,218.86696729417736,0.06666666666666667
2551,19310,19320,10,305.83841288833804,0.3333333333333333
2552,19321,19324,3,391.454931890969,0.1
2553,19325,19336,11,237.2133463089382,0.36666666666666664
2554,19337,19337,0,81.63283642631998,0.0
2555,19338,19340,2,218.30685318968958,0.06666666666666667
2556,19341,19343,2,376.4411315169555,0.06666666666666667
2557,19344,19355,11,675.924971231939,0.36666666666666664
2558,19356,19362,6,473.29050020529365,0.2
2559,19363,19363,0,211.90190407462194,0.0
2560,19365,19366,1,690.965553676751,0.03333333333333333
2561,19369,19369,0,295.02653653960493,0.0
2562,19370,19372,2,405.89538653207137,0.06666666666666667
2563,19373,19373,0,298.39063814395314,0.0
2564,19374,19374,0,428.45181221100637,0.0
2565,19375,19375,0,166.85913951799205,0.0
2566,19376,19378,2,517.9339472481688,0.06666666666666667
2567,19379,19379,0,280.5934833162674,0.0
2568,19380,19381,1,487.82749271171224,0.03333333333333333
2569,19382,19383,1,371.15563423461776,0.03333333333333333
2570,19384,19387,3,275.5611456289904,0.1
2571,19388,19388,0,632.4592505151631,0.0
2572,19391,19392,1,307.7629828860689,0.03333333333333333
2573,19393,19396,3,210.26721925979834,0.1
2574,19403,19404,1,326.2735510242322,0.03333333333333333
2575,19405,19407,2,216.6964139196668,0.06666666666666667
2576,19408,19409,1,80.09162824835614,0.03333333333333333
2577,19410,19414,4,189.57316489995657,0.13333333333333333
2578,19415,19415,0,375.8425795229274,0.0
2579,19416,19426,10,194.97553078578983,0.3333333333333333
2580,19428,19430,2,422.93324361492637,0.06666666666666667
2581,19431,19432,1,512.6450586088527,0.03333333333333333
2582,19433,19433,0,153.73815353480182,0.0
2583,19434,19434,0,462.7388662164214,0.0
2584,19435,19435,0,158.56135348282984,0.0
2585,19436,19439,3,425.17711210162787,0.1
2586,19441,19441,0,157.32288329149628,0.0
2587,19442,19443,1,347.28133987380494,0.03333333333333333
2588,19444,19447,3,481.08041445312017,0.1
2589,19448,19464,16,473.5599720088213,0.5333333333333333
2590,19465,19465,0,288.0565679982524,0.0
2591,19466,19466,0,441.88279563355076,0.0
2592,19467,19468,1,270.40357262329627,0.03333333333333333
2593,19469,19472,3,414.1827477237051,0.1
2594,19473,19473,0,293.8766160326427,0.0
2595,19474,19478,4,358.03249815950875,0.13333333333333333
2596,19479,19479,0,442.36161287781925,0.0
2597,19480,19481,1,204.7830525789491,0.03333333333333333
2598,19482,19488,6,363.18882199451247,0.2
2599,19489,19492,3,178.08559859889726,0.1
2600,19493,19493,0,360.76842733256626,0.0
2601,19494,19516,22,400.4198668776748,0.7333333333333333
2602,19517,19517,0,136.59062336479857,0.0
2603,19518,19576,58,225.95488145596656,1.9333333333333333
2604,19577,19579,2,273.66901184495447,0.06666666666666667
2605,19580,19581,1,132.82453531214114,0.03333333333333333
2606,19582,19583,1,376.1390095215561,0.03333333333333333
2607,19584,19585,1,172.01171122219483,0.03333333333333333
2608,19586,19586,0,377.93862938796883,0.0
2609,19587,19595,8,147.75673221246197,0.26666666666666666
2610,19596,19596,0,422.5018964928964,0.0
2611,19597,19597,0,143.61081628697718,0.0
2612,19598,19598,0,422.0724803687258,0.0
2613,19599,19611,12,150.04030184474516,0.4
2614,19612,19617,5,448.75970287224715,0.16666666666666666
2615,19618,19619,1,157.62410415481702,0.03333333333333333
2616,19620,19620,0,293.1029764943564,0.0
2617,19621,19639,18,152.20290613622657,0.6
2618,19640,19640,0,416.6787750083999,0.0
2619,19641,19641,0,142.1492153968704,0.0
2620,19642,19645,3,423.98965648659686,0.1
2621,19649,19656,7,167.85791239041515,0.23333333333333334
2622,19658,19658,0,503.0669296142584,0.0
2623,19659,19660,1,394.74430859656763,0.03333333333333333
2624,19661,19662,1,504.1107200756832,0.03333333333333333
2625,19664,19664,0,401.57625053683904,0.0
2626,19665,19667,2,101.4941793509815,0.06666666666666667
2627,19668,19668,0,315.95707317294836,0.0
2628,19669,19674,5,99.66864580239489,0.16666666666666666
2629,19675,19675,0,245.38921354293836,0.0
2630,19676,19676,0,99.54600801535588,0.0
2631,19679,19679,0,362.3935205298976,0.0
2632,19681,19682,1,220.8968938543249,0.03333333333333333
2633,19683,19686,3,114.5196363778063,0.1
2634,19687,19690,3,315.0561797890696,0.1
2635,19691,19691,0,108.6273452000762,0.0
2636,19693,19699,6,316.93509032088974,0.2
2637,19700,19702,2,145.31917844033694,0.06666666666666667
2638,19703,19704,1,331.63609047241306,0.03333333333333333
2639,19705,19756,51,174.25996201801013,1.7
2640,19764,19770,6,236.10812970891334,0.2
2641,19771,19791,20,431.76444273534406,0.6666666666666666
2642,19792,19805,13,385.86349570960544,0.43333333333333335
2643,19806,19808,2,522.1689806438218,0.06666666666666667
2644,19809,19814,5,394.59417873811054,0.16666666666666666
2645,19815,19816,1,201.19379046742046,0.03333333333333333
2646,19817,19817,0,576.4985024375708,0.0
2647,19818,19818,0,438.84939883936244,0.0
2648,19819,19819,0,541.2136165486634,0.0
2649,19820,19821,1,371.19023722907946,0.03333333333333333
2650,19822,19822,0,203.1077999612753,0.0
2651,19823,19824,1,392.52793352702065,0.03333333333333333
2652,19827,19830,3,251.01323218496236,0.1
2653,19833,19837,4,372.0075350990512,0.13333333333333333
2654,19839,19842,3,205.652991303149,0.1
2655,19843,19854,11,310.10443562748503,0.36666666666666664
2656,19855,19859,4,247.86857586066355,0.13333333333333333
2657,19860,19860,0,191.42617216083266,0.0
2658,19861,19861,0,333.12304171579603,0.0
2659,19862,19862,0,644.1561203032331,0.0
2660,19863,19865,2,446.9283606320996,0.06666666666666667
2661,19866,19870,4,300.0561128363103,0.13333333333333333
2662,19872,19872,0,436.3330603317194,0.0
2663,19874,19875,1,262.63658142599115,0.03333333333333333
2664,19883,19922,39,107.66052775024376,1.3
2665,19942,19944,2,420.69393150946576,0.06666666666666667
2666,19945,19945,0,67.3797508804782,0.0
2667,19947,19947,0,429.92293959779903,0.0
2668,19957,19959,2,555.5449687632403,0.06666666666666667
2669,19977,19978,1,464.83898436146046,0.03333333333333333
2670,20020,20020,0,98.38100135182071,0.0
2671,20037,20039,2,405.6143787499568,0.06666666666666667
2672,20049,20054,5,63.132570013681914,0.16666666666666666
2673,20059,20075,16,191.83721906855317,0.5333333333333333
2674,20125,20125,0,123.8894313795899,0.0
2675,20126,20126,0,8.584724600959142,0.0
2676,20127,20132,5,114.48883542549463,0.16666666666666666
2677,20133,20135,2,246.5816232912767,0.06666666666666667
2678,20136,20137,1,396.1041347461632,0.03333333333333333
2679,20138,20138,0,207.3810116693834,0.0
2680,20139,20139,0,344.56004427641284,0.0
2681,20140,20140,0,115.8119394419135,0.0
2682,20141,20152,11,397.3606905121712,0.36666666666666664
2683,20153,20163,10,218.8572497420863,0.3333333333333333
2684,20164,20164,0,419.160604887144,0.0
2685,20172,20173,1,118.10630011789661,0.03333333333333333
2686,20174,20181,7,302.13184322269785,0.23333333333333334
2687,20182,20183,1,407.9289154198598,0.03333333333333333
2688,20184,20190,6,123.40147100702545,0.2
2689,20191,20191,0,304.3534139095686,0.0
2690,20192,20192,0,123.09661455675364,0.0
2691,20193,20193,0,298.4807539485775,0.0
2692,20194,20194,0,123.49829609861843,0.0
2693,20195,20196,1,291.58928672117923,0.03333333333333333
2694,20197,20202,5,117.17954485050306,0.16666666666666666
2695,20204,20212,8,364.60476215858097,0.26666666666666666
2696,20213,20213,0,482.48928107544015,0.0
2697,20214,20227,13,397.88413537723494,0.43333333333333335
2698,20228,20231,3,512.990502022705,0.1
2699,20232,20236,4,391.977763340736,0.13333333333333333
2700,20237,20237,0,293.91795461867105,0.0
2701,20238,20263,25,438.33265682209515,0.8333333333333334
2702,20264,20272,8,378.8469370066016,0.26666666666666666
2703,20274,20274,0,148.4336687291335,0.0
2704,20275,20282,7,376.00330922761646,0.23333333333333334
2705,20283,20284,1,332.5074920982886,0.03333333333333333
2706,20285,20300,15,445.43268538035767,0.5
2707,20301,20303,2,60.34843021116188,0.06666666666666667
2708,20304,20305,1,498.1434047721465,0.03333333333333333
2709,20306,20307,1,72.07378557955111,0.03333333333333333
2710,20308,20309,1,517.1836702493785,0.03333333333333333
2711,20310,20325,15,399.81128089917166,0.5
2712,20326,20326,0,552.540130197405,0.0
2713,20331,20345,14,426.3925585643306,0.4666666666666667
2714,20346,20351,5,496.1990051072033,0.16666666666666666
2715,20352,20355,3,530.5698193566805,0.1
2716,20367,20406,39,371.31902860856206,1.3
2717,20407,20407,0,462.9476944800368,0.0
2718,20411,20414,3,371.45687317954844,0.1
2719,20415,20419,4,298.31219107549185,0.13333333333333333
2720,20420,20420,0,495.3650925091427,0.0
2721,20421,20432,11,345.2537792100816,0.36666666666666664
2722,20433,20434,1,510.3952370739738,0.03333333333333333
2723,20435,20439,4,343.41476217617173,0.13333333333333333
2724,20440,20440,0,485.1804901090855,0.0
2725,20441,20446,5,277.8373746060393,0.16666666666666666
2726,20447,20452,5,371.33633769495617,0.16666666666666666
2727,20453,20458,5,499.59859583023234,0.16666666666666666
2728,20459,20460,1,214.0122164930707,0.03333333333333333
2729,20461,20461,0,546.9127211838123,0.0
2730,20462,20462,0,439.6791162251592,0.0
2731,20463,20463,0,117.69728823690645,0.0
2732,20464,20464,0,255.18064549949023,0.0
2733,20465,20467,2,319.9199525673669,0.06666666666666667
2734,20468,20469,1,177.88983462184868,0.03333333333333333
2735,20470,20470,0,419.12423805527595,0.0
2736,20471,20472,1,310.27691466584065,0.03333333333333333
2737,20473,20473,0,475.13414216551854,0.0
2738,20474,20475,1,236.6117729600271,0.03333333333333333
2739,20476,20476,0,378.3426600074151,0.0
2740,20477,20479,2,484.0535989175482,0.06666666666666667
2741,20480,20480,0,576.1856833638423,0.0
2742,20481,20739,258,526.601718224075,8.6
2743,20740,20740,0,305.00315514158353,0.0
2744,20741,20745,4,498.0308257411808,0.13333333333333333
2745,20746,20746,0,351.4160182610319,0.0
2746,20747,20764,17,249.04513005377328,0.5666666666666667
2747,20765,20773,8,219.20146463485617,0.26666666666666666
2748,20774,20780,6,284.32379357320576,0.2
2749,20781,20781,0,370.9281911732659,0.0
2750,20782,20783,1,241.96205925811768,0.03333333333333333
2751,20784,20788,4,363.02304251636576,0.13333333333333333
2752,20789,20789,0,231.80100601691643,0.0
2753,20790,20800,10,302.16543250412866,0.3333333333333333
2754,20801,20805,4,326.1966807024777,0.13333333333333333
2755,20806,20806,0,88.3427913253566,0.0
2756,20807,20816,9,325.0249513559158,0.3
2757,20817,20898,81,309.97212339948896,2.7
2758,20899,20899,0,191.57022928312176,0.0
2759,20900,20909,9,363.95640491295933,0.3
2760,20910,20920,10,261.5660063396601,0.3333333333333333
2761,20921,20925,4,408.2313632181419,0.13333333333333333
2762,20926,20926,0,228.11438573700605,0.0
2763,20927,20928,1,381.15644384290476,0.03333333333333333
2764,20929,20929,0,205.9107324563591,0.0
2765,20930,20940,10,318.4606974140564,0.3333333333333333
2766,20941,20945,4,161.13347824737994,0.13333333333333333
2767,20946,20946,0,289.59610336574826,0.0
2768,20947,20955,8,178.06032874848495,0.26666666666666666
2769,20956,20963,7,111.19569895468612,0.23333333333333334
2770,20966,20966,0,279.4186525822699,0.0
2771,20967,20989,22,149.15231423802348,0.7333333333333333
2772,20992,20994,2,421.40564536357556,0.06666666666666667
2773,20995,20997,2,175.84100698206362,0.06666666666666667
2774,21000,21035,35,323.25933061217654,1.1666666666666667
2775,21036,21050,14,373.88863801483944,0.4666666666666667
2776,21051,21053,2,427.6217671373661,0.06666666666666667
2777,21054,21055,1,280.13775264179384,0.03333333333333333
2778,21056,21058,2,340.2213252221277,0.06666666666666667
2779,21060,21066,6,480.62676467656365,0.2
2780,21067,21067,0,676.2802332155425,0.0
2781,21068,21070,2,264.60199322562795,0.06666666666666667
2782,21071,21077,6,205.97095217395653,0.2
2783,21078,21085,7,307.14877720441706,0.23333333333333334
2784,21086,21086,0,183.14513790530907,0.0
2785,21087,21088,1,347.2533989297318,0.03333333333333333
2786,21089,21090,1,237.9367011740165,0.03333333333333333
2787,21091,21091,0,426.1625359894745,0.0
2788,21092,21092,0,304.3843795106547,0.0
2789,21093,21100,7,386.2315341451681,0.23333333333333334
2790,21101,21104,3,365.12358806265627,0.1
2791,21105,21106,1,305.9126598789653,0.03333333333333333
2792,21107,21107,0,434.7085322129593,0.0
2793,21108,21109,1,283.8198556755465,0.03333333333333333
2794,21110,21111,1,442.593078053282,0.03333333333333333
2795,21112,21114,2,262.5709152610715,0.06666666666666667
2796,21115,21121,6,398.98339440846536,0.2
2797,21122,21135,13,316.7957356609152,0.43333333333333335
2798,21136,21149,13,293.7853274325579,0.43333333333333335
2799,21150,21150,0,195.63187282760626,0.0
2800,21151,21160,9,323.1125393883762,0.3
2801,21161,21161,0,233.82818865703265,0.0
2802,21162,21165,3,304.774747044068,0.1
2803,21166,21166,0,378.269441776624,0.0
2804,21167,21167,0,136.83095770935276,0.0
2805,21168,21168,0,288.2250811693155,0.0
2806,21169,21169,0,117.23854133502905,0.0
2807,21170,21170,0,281.67628488815967,0.0
2808,21171,21173,2,482.9159856101844,0.06666666666666667
2809,21174,21175,1,264.51648014653125,0.03333333333333333
2810,21176,21178,2,464.11356061546957,0.06666666666666667
2811,21179,21179,0,350.4330233857296,0.0
2812,21180,21182,2,479.49446771112315,0.06666666666666667
2813,21183,21183,0,706.9474790859027,0.0
2814,21184,21184,0,414.82673935970104,0.0
2815,21185,21187,2,363.7875709274038,0.06666666666666667
2816,21188,21188,0,299.27175059864334,0.0
2817,21189,21207,18,395.9334278958304,0.6
2818,21208,21213,5,366.22587525794097,0.16666666666666666
2819,21218,21218,0,177.66735893876148,0.0
2820,21219,21219,0,376.32389108895137,0.0
2821,21220,21220,0,128.90186856923813,0.0
2822,21223,21224,1,286.77870901313247,0.03333333333333333
2823,21234,21234,0,83.07118504547239,0.0
2824,21237,21238,1,424.5399134812575,0.03333333333333333
2825,21256,21256,0,387.41414771322854,0.0
2826,21257,21258,1,81.08135436136223,0.03333333333333333
2827,21261,21261,0,316.4293490630629,0.0
2828,21361,21361,0,73.47414034080641,0.0
2829,21366,21387,21,204.1511220947705,0.7
2830,21388,21392,4,356.5052453209063,0.13333333333333333
2831,21396,21398,2,204.46749191459074,0.06666666666666667
2832,21399,21399,0,425.7418152735042,0.0
2833,21400,21400,0,188.51106157414625,0.0
2834,21416,21438,22,209.12319641131987,0.7333333333333333
2835,21440,21449,9,222.95340098660432,0.3
2836,21450,21452,2,397.42453567668366,0.06666666666666667
2837,21453,21477,24,376.1035943951031,0.8
2838,21478,21478,0,159.35752775886138,0.0
2839,21479,21479,0,421.6051104034841,0.0
2840,21480,21480,0,205.52090068345163,0.0
2841,21481,21481,0,382.15299207470633,0.0
2842,21482,21486,4,279.5710230365956,0.13333333333333333
2843,21487,21487,0,487.46786173733364,0.0
2844,21488,21493,5,238.0646050997676,0.16666666666666666
2845,21495,21495,0,306.33288739528325,0.0
2846,21496,21504,8,240.05760186997088,0.26666666666666666
2847,21505,21505,0,153.01396191159327,0.0
2848,21506,21507,1,279.09045284100057,0.03333333333333333
2849,21508,21508,0,393.56457780914644,0.0
2850,21509,21512,3,347.97448953576315,0.1
2851,21513,21513,0,138.01719100496533,0.0
2852,21514,21517,3,311.95293294316696,0.1
2853,21518,21522,4,485.1939630331925,0.13333333333333333
2854,21523,21523,0,279.4058632241139,0.0
2855,21524,21526,2,378.7523969545926,0.06666666666666667
2856,21527,21529,2,433.9030926378173,0.06666666666666667
2857,21530,21530,0,552.9428993599035,0.0
2858,21531,21531,0,280.68537232006736,0.0
2859,21532,21532,0,458.7651626676082,0.0
2860,21533,21542,9,434.0691608638962,0.3
2861,21543,21544,1,237.80543583774147,0.03333333333333333
2862,21545,21546,1,370.2163155202193,0.03333333333333333
2863,21551,21560,9,257.49604005522883,0.3
2864,21561,21561,0,430.3325887794486,0.0
2865,21562,21563,1,299.3743747736998,0.03333333333333333
2866,21564,21567,3,446.18109080468497,0.1
2867,21568,21569,1,318.48953001109055,0.03333333333333333
2868,21570,21576,6,377.70754437467264,0.2
2869,21584,21595,11,105.95442081196101,0.36666666666666664
2870,21596,21598,2,285.9240392398254,0.06666666666666667
2871,21599,21599,0,876.3427056470684,0.0
2872,21600,21600,0,409.9035005961483,0.0
2873,21601,21608,7,553.6769599702995,0.23333333333333334
2874,21609,21609,0,447.9003662683423,0.0
2875,21610,21610,0,748.7510910459304,0.0
2876,21611,21614,3,603.5956631647932,0.1
2877,21615,21620,5,474.05681430199786,0.16666666666666666
2878,21621,21621,0,575.8577396026666,0.0
2879,21622,21627,5,524.5812847161152,0.16666666666666666
2880,21628,21628,0,347.81294555403497,0.0
2881,21629,21629,0,499.43605985119564,0.0
2882,21630,21641,11,461.2825392360891,0.36666666666666664
2883,21642,21642,0,738.0084691828968,0.0
2884,21646,21649,3,402.9732136283464,0.1
2885,21650,21666,16,472.7568033822793,0.5333333333333333
2886,21667,21679,12,327.72276834029157,0.4
2887,21680,21702,22,425.0149867274259,0.7333333333333333
2888,21708,21708,0,120.20120034926559,0.0
2889,21711,21711,0,398.44357073053214,0.0
2890,21724,21732,8,263.10242291736733,0.26666666666666666
2891,21751,21751,0,465.75202312442445,0.0
2892,21758,21759,1,138.03954930075406,0.03333333333333333
2893,21760,21764,4,397.49289079800076,0.13333333333333333
2894,21765,21784,19,175.57815224917772,0.6333333333333333
2895,21785,21790,5,168.5889045030994,0.16666666666666666
2896,21791,21791,0,314.6712171969493,0.0
2897,21792,21803,11,263.7596305757966,0.36666666666666664
2898,21804,21820,16,293.4222041379139,0.5333333333333333
2899,21821,21823,2,155.7700849141677,0.06666666666666667
2900,21824,21824,0,335.4529499034818,0.0
2901,21825,21828,3,134.81561005817989,0.1
2902,21829,21832,3,333.7591226735278,0.1
2903,21833,21836,3,180.69083312493933,0.1
2904,21837,21837,0,360.1594260064162,0.0
2905,21838,21838,0,238.1139615188759,0.0
2906,21839,21839,0,341.96347674137974,0.0
2907,21840,21840,0,170.8273001094971,0.0
2908,21841,21846,5,330.1007986636958,0.16666666666666666
2909,21847,21860,13,343.8479707760853,0.43333333333333335
2910,21861,21861,0,460.84015557903587,0.0
2911,21862,21862,0,355.93163059987353,0.0
2912,21863,21870,7,475.3028580783228,0.23333333333333334
2913,21871,21875,4,488.21215488225164,0.13333333333333333
2914,21876,21883,7,437.8787875637793,0.23333333333333334
2915,21884,21884,0,544.015752990504,0.0
2916,21885,21885,0,232.95433716820483,0.0
2917,21886,21886,0,519.460900744454,0.0
2918,21887,21887,0,251.9992104987671,0.0
2919,21888,21888,0,439.16582022223344,0.0
2920,21889,21891,2,559.566598314797,0.06666666666666667
2921,21892,21892,0,403.7367194107805,0.0
2922,21894,21895,1,577.4804791172373,0.03333333333333333
2923,21896,21896,0,380.0747723053919,0.0
2924,21897,21898,1,518.2871426423858,0.03333333333333333
2925,21899,21899,0,251.29528462615033,0.0
2926,21900,21900,0,357.46974821859976,0.0
2927,21901,21902,1,264.2428349963608,0.03333333333333333
2928,21904,21908,4,507.5382218117337,0.13333333333333333
2929,21909,21909,0,363.4576849940175,0.0
2930,21910,21910,0,548.3413965528342,0.0
2931,21911,21913,2,429.44610178130523,0.06666666666666667
2932,21914,21914,0,161.68729052704734,0.0
2933,21916,21917,1,319.27989437241814,0.03333333333333333
2934,21918,21918,0,461.4124383621199,0.0
2935,21919,21919,0,760.6865379344175,0.0
2936,21920,21931,11,531.1214665487548,0.36666666666666664
2937,21932,21936,4,457.96006611292023,0.13333333333333333
2938,21956,21982,26,414.0327547586904,0.8666666666666667
2939,21983,21983,0,203.97334328156992,0.0
2940,21984,21984,0,439.4731876416149,0.0
2941,21985,21989,4,236.54111442052582,0.13333333333333333
2942,21991,21991,0,413.80683077015544,0.0
2943,21993,21993,0,266.8931040540977,0.0
2944,21996,21997,1,456.5618255046543,0.03333333333333333
2945,22000,22000,0,242.31796539625353,0.0
2946,22001,22008,7,418.99810034472455,0.23333333333333334
2947,22013,22013,0,308.5440949911178,0.0
2948,22018,22021,3,418.5308007244146,0.1
2949,22022,22022,0,545.4436380029543,0.0
2950,22023,22029,6,305.9171056289705,0.2
2951,22030,22039,9,369.313569802208,0.3
2952,22040,22043,3,476.42496868118155,0.1
2953,22044,22045,1,370.08690656874523,0.03333333333333333
2954,22046,22050,4,583.302712707934,0.13333333333333333
2955,22051,22051,0,462.4112194276879,0.0
2956,22052,22052,0,297.8750951923141,0.0
2957,22053,22057,4,576.2712760067462,0.13333333333333333
2958,22058,22058,0,248.2451391844954,0.0
2959,22059,22062,3,351.4690630940465,0.1
2960,22063,22072,9,504.45562776292115,0.3
2961,22073,22074,1,468.7229948576465,0.03333333333333333
2962,22075,22075,0,657.2989061448096,0.0
2963,22076,22076,0,856.0652645324523,0.0
2964,22077,22077,0,656.5418252530089,0.0
2965,22078,22079,1,177.50957825191418,0.03333333333333333
2966,22080,22081,1,631.1178346631442,0.03333333333333333
2967,22082,22083,1,543.3929546818572,0.03333333333333333
2968,22084,22084,0,258.9342014921999,0.0
2969,22085,22098,13,470.83776243003604,0.43333333333333335
2970,22099,22101,2,464.35069576667246,0.06666666666666667
2971,22102,22102,0,609.1162960200691,0.0
2972,22103,22109,6,434.9821472023041,0.2
2973,22110,22132,22,462.34142099894797,0.7333333333333333
2974,22133,22190,57,457.39657510707383,1.9
2975,22191,22193,2,343.8547826094498,0.06666666666666667
2976,22194,22194,0,465.96079052464097,0.0
2977,22195,22196,1,303.41888579617216,0.03333333333333333
2978,22197,22199,2,515.1664527803119,0.06666666666666667
2979,22200,22201,1,377.14761275297843,0.03333333333333333
2980,22202,22202,0,437.5615750689353,0.0
2981,22203,22203,0,289.83387514975027,0.0
2982,22204,22208,4,395.00330782266684,0.13333333333333333
2983,22209,22229,20,419.67383722379185,0.6666666666666666
2984,22248,22297,49,476.9407781076784,1.6333333333333333
2985,22298,22301,3,330.6855875455959,0.1
2986,22302,22305,3,429.4716523361181,0.1
2987,22306,22306,0,521.3994668887092,0.0
2988,22307,22338,31,369.5207071678596,1.0333333333333334
2989,22339,22345,6,457.28698781358304,0.2
2990,22346,22359,13,370.48524925090356,0.43333333333333335
2991,22360,22542,182,494.914434513688,6.066666666666666
2992,22543,22553,10,524.7079828971703,0.3333333333333333
2993,22554,22555,1,345.40469497331327,0.03333333333333333
2994,22556,22577,21,488.68665628452123,0.7
2995,22578,22583,5,358.07100701580475,0.16666666666666666
2996,22584,22657,73,474.5574313047767,2.433333333333333
2997,22658,22659,1,249.71284823055436,0.03333333333333333
2998,22664,22664,0,400.01362204210045,0.0
2999,22665,22666,1,538.8825859270648,0.03333333333333333
3000,22667,22697,30,501.9770099055176,1.0
3001,22698,22698,0,324.58329033631173,0.0
3002,22699,22699,0,462.164809132938,0.0
3003,22700,22700,0,320.7915625188257,0.0
3004,22701,22706,5,430.4153371245022,0.16666666666666666
3005,22707,22716,9,503.5154455104656,0.3
3006,22717,22718,1,258.38045996027665,0.03333333333333333
3007,22719,22720,1,572.5091321707824,0.03333333333333333
3008,22721,22721,0,442.3242145847163,0.0
3009,22723,22724,1,211.78832832772596,0.03333333333333333
3010,22725,22725,0,610.2585982031703,0.0
3011,22726,22726,0,202.8856898310906,0.0
3012,22727,22727,0,483.79093267393256,0.0
3013,22728,22728,0,203.11576623356146,0.0
3014,22729,22729,0,546.3292263100095,0.0
3015,22730,22731,1,657.2547996339001,0.03333333333333333
3016,22732,22732,0,787.4265095533362,0.0
3017,22733,22734,1,585.5412491838836,0.03333333333333333
3018,22735,22737,2,361.2205906566894,0.06666666666666667
3019,22738,22743,5,336.3903386357684,0.16666666666666666
3020,22744,22744,0,463.23393067459796,0.0
3021,22745,22746,1,348.7734155811516,0.03333333333333333
3022,22747,22747,0,506.0817182401437,0.0
3023,22748,22749,1,357.44970358852754,0.03333333333333333
3024,22750,22750,0,493.5812906059924,0.0
3025,22751,22759,8,422.886871085702,0.26666666666666666
3026,22760,22762,2,566.3453593500177,0.06666666666666667
3027,22763,22764,1,418.8844044210914,0.03333333333333333
3028,22765,22765,0,340.6237103979239,0.0
3029,22766,22767,1,425.8942872883031,0.03333333333333333
3030,22768,22773,5,474.33552078190104,0.16666666666666666
3031,22774,22774,0,599.1384106046013,0.0
3032,22775,22775,0,494.73016289357366,0.0
3033,22776,22778,2,373.6652081435223,0.06666666666666667
3034,22779,22779,0,256.7552771999423,0.0
3035,22780,22782,2,297.2677426910829,0.06666666666666667
3036,22783,22796,13,406.76319754581885,0.43333333333333335
3037,22797,22798,1,411.28880477881364,0.03333333333333333
3038,22799,22801,2,509.24666654879434,0.06666666666666667
3039,22802,22802,0,627.4333045493285,0.0
3040,22803,22812,9,453.53997390680235,0.3
3041,22813,22814,1,458.02293642064666,0.03333333333333333
3042,22815,22816,1,340.8577330740647,0.03333333333333333
3043,22817,22817,0,215.18237215232656,0.0
3044,22818,22822,4,338.6046816089637,0.13333333333333333
3045,22823,22823,0,154.3762713762672,0.0
3046,22824,22838,14,388.6808609534308,0.4666666666666667
3047,22839,22841,2,568.3892356827768,0.06666666666666667
3048,22842,22843,1,440.89326930656944,0.03333333333333333
3049,22844,22844,0,701.009829208649,0.0
3050,22845,22853,8,544.450084978304,0.26666666666666666
3051,22854,22854,0,482.39235120084453,0.0
3052,22855,22855,0,327.6235646146358,0.0
3053,22856,22856,0,572.4683747239371,0.0
3054,22857,22857,0,325.03014866245644,0.0
3055,22858,22858,0,571.5362261635283,0.0
3056,22859,22859,0,348.4137324705909,0.0
3057,22862,22874,12,582.6903232521323,0.4
3058,22879,22879,0,44.03035898904876,0.0
3059,22883,22887,4,575.534135324435,0.13333333333333333
3060,22888,22892,4,435.2018115208528,0.13333333333333333
3061,22893,22893,0,55.37552695202618,0.0
3062,22894,22896,2,397.9432105895107,0.06666666666666667
3063,22897,22899,2,63.20739810674062,0.06666666666666667
3064,22900,22900,0,388.78582871980626,0.0
3065,22901,22901,0,66.44291067097355,0.0
3066,22902,22902,0,386.429702677794,0.0
3067,22903,22904,1,69.7784128565452,0.03333333333333333
3068,22905,22905,0,382.7126450900194,0.0
3069,22906,22906,0,74.75270567054906,0.0
3070,22907,22922,15,450.4014180172527,0.5
3071,22923,22927,4,101.30889727783696,0.13333333333333333
3072,22928,22930,2,353.9446838364417,0.06666666666666667
3073,22931,22931,0,106.65081772726708,0.0
3074,22932,22934,2,450.4445324198711,0.06666666666666667
3075,22935,22936,1,341.18308548569223,0.03333333333333333
3076,22937,22942,5,449.6558779161215,0.16666666666666666
3077,22943,22943,0,331.9149598115341,0.0
3078,22944,22945,1,431.4538707889956,0.03333333333333333
3079,22946,22946,0,569.0718218290509,0.0
3080,22947,22947,0,465.7215982316787,0.0
3081,22948,22950,2,567.0649265655159,0.06666666666666667
3082,22951,22951,0,461.12193369722263,0.0
3083,22952,22956,4,565.1327393188226,0.13333333333333333
3084,22957,22958,1,422.1908813102551,0.03333333333333333
3085,22960,22960,0,566.2723698613948,0.0
3086,22961,22962,1,439.8675322970216,0.03333333333333333
3087,22963,22967,4,567.2144835435063,0.13333333333333333
3088,22971,22971,0,442.68002595069225,0.0
3089,22974,22981,7,252.63827465029345,0.23333333333333334
3090,22982,22982,0,492.8816196167432,0.0
3091,22983,22985,2,621.907997010973,0.06666666666666667
3092,22986,22986,0,449.14537017989795,0.0
3093,22987,22987,0,343.504759509307,0.0
3094,22988,22988,0,449.7697932681622,0.0
3095,22989,22990,1,579.3125613545831,0.03333333333333333
3096,22992,23023,31,473.86921758697036,1.0333333333333334
3097,23024,23034,10,483.20815587450693,0.3333333333333333
3098,23035,23049,14,454.9417006564864,0.4666666666666667
3099,23050,23050,0,643.0639231771705,0.0
3100,23051,23053,2,537.0561835226396,0.06666666666666667
3101,23054,23056,2,478.47479773712007,0.06666666666666667
3102,23057,23057,0,698.5790228233245,0.0
3103,23058,23079,21,492.1071116737352,0.7
3104,23080,23080,0,552.8360877289981,0.0
3105,23081,23084,3,509.8772860670913,0.1
3106,23085,23086,1,367.2904419625661,0.03333333333333333
3107,23087,23087,0,443.7765124962349,0.0
3108,23088,23091,3,492.36496714173495,0.1
3109,23092,23101,9,573.4234590298748,0.3
3110,23102,23104,2,498.89101961805244,0.06666666666666667
3111,23105,23113,8,487.56334119717695,0.26666666666666666
3112,23114,23116,2,551.8615711906309,0.06666666666666667
3113,23117,23117,0,403.20404848992916,0.0
3114,23118,23118,0,240.15636570656724,0.0
3115,23119,23122,3,446.5745609561926,0.1
3116,23123,23126,3,364.4264637853766,0.1
3117,23127,23138,11,515.0001723150227,0.36666666666666664
3118,23139,23145,6,456.7805172986515,0.2
3119,23146,23147,1,589.7966699791796,0.03333333333333333
3120,23148,23148,0,445.06031313551125,0.0
3121,23149,23153,4,546.3541904405982,0.13333333333333333
3122,23154,23164,10,498.82116202474043,0.3333333333333333
3123,23165,23166,1,344.1501004730136,0.03333333333333333
3124,23167,23170,3,521.1198735770704,0.1
3125,23171,23171,0,641.932543164516,0.0
3126,23172,23173,1,401.05198477676555,0.03333333333333333
3127,23174,23174,0,595.9118296901787,0.0
3128,23175,23180,5,439.34231248315496,0.16666666666666666
3129,23181,23181,0,328.8105635054382,0.0
3130,23182,23183,1,502.09436154949594,0.03333333333333333
3131,23184,23186,2,369.9788781078803,0.06666666666666667
3132,23187,23215,28,483.378326302916,0.9333333333333333
3133,23216,23226,10,430.94865366704704,0.3333333333333333
3134,23227,23229,2,350.4998032511303,0.06666666666666667
3135,23230,23235,5,499.106801325061,0.16666666666666666
3136,23236,23236,0,352.5831665457641,0.0
3137,23237,23239,2,481.7582424027766,0.06666666666666667
3138,23240,23246,6,372.782081568581,0.2
3139,23247,23248,1,253.3021489859164,0.03333333333333333
3140,23252,23252,0,423.93634866041066,0.0
3141,23253,23255,2,252.97290113831886,0.06666666666666667
3142,23256,23256,0,432.56641948552505,0.0
3143,23257,23257,0,223.2371136749947,0.0
3144,23258,23258,0,371.5164819145259,0.0
3145,23259,23282,23,434.38366345857634,0.7666666666666667
3146,23283,23285,2,321.2278589086407,0.06666666666666667
3147,23286,23286,0,235.78544160112676,0.0
3148,23287,23296,9,371.5581565516557,0.3
3149,23297,23297,0,271.8879374210812,0.0
3150,23298,23301,3,575.8818823630932,0.1
3151,23302,23302,0,392.77550261067853,0.0
3152,23303,23304,1,246.08262535753346,0.03333333333333333
3153,23305,23307,2,287.68750074691553,0.06666666666666667
3154,23308,23308,0,487.20462374692687,0.0
3155,23309,23310,1,340.45841776015317,0.03333333333333333
3156,23311,23311,0,482.0932705399388,0.0
3157,23312,23328,16,315.13717049802267,0.5333333333333333
3158,23329,23329,0,340.2562150170029,0.0
3159,23330,23330,0,189.5941062388382,0.0
3160,23331,23348,17,272.0035647736101,0.5666666666666667
3161,23349,23351,2,164.1882834663515,0.06666666666666667
3162,23352,23353,1,370.01734516127,0.03333333333333333
3163,23354,23354,0,131.4235800264762,0.0
3164,23355,23369,14,383.1269331074869,0.4666666666666667
3165,23370,23371,1,183.89166236049712,0.03333333333333333
3166,23372,23400,28,388.6908835957691,0.9333333333333333
3167,23401,23422,21,392.1982832880034,0.7
3168,23423,23423,0,579.5500674506438,0.0
3169,23424,23425,1,406.75459783299516,0.03333333333333333
3170,23426,23426,0,580.4530834593681,0.0
3171,23427,23427,0,408.73215185434174,0.0
3172,23428,23429,1,581.2119899070091,0.03333333333333333
3173,23430,23430,0,459.2335641679142,0.0
3174,23431,23432,1,335.0806973300983,0.03333333333333333
3175,23433,23444,11,579.131124867581,0.36666666666666664
3176,23445,23456,11,503.83182651892145,0.36666666666666664
3177,23457,23466,9,343.8291766046184,0.3
3178,23467,23483,16,526.2914288386631,0.5333333333333333
3179,23484,23495,11,402.8045288901073,0.36666666666666664
3180,23496,23501,5,521.8434754960618,0.16666666666666666
3181,23502,23519,17,483.64476524727735,0.5666666666666667
3182,23520,23521,1,293.4158546544817,0.03333333333333333
3183,23522,23525,3,430.86487919183645,0.1
3184,23526,23527,1,268.77394002516803,0.03333333333333333
3185,23528,23548,20,392.388719169217,0.6666666666666666
3186,23549,23600,51,284.2679578202678,1.7
3187,23601,23607,6,306.77613343962565,0.2
3188,23608,23609,1,374.7185071811648,0.03333333333333333
3189,23610,23642,32,360.6372579146614,1.0666666666666667
3190,23643,23643,0,464.1530880202467,0.0
3191,23644,23701,57,409.90961883316317,1.9
3192,23702,23709,7,262.09625341145926,0.23333333333333334
3193,23711,23711,0,461.6954100255726,0.0
3194,23712,23715,3,391.3153334210082,0.1
3195,23716,23716,0,542.4883832018897,0.0
3196,23717,23717,0,350.0785881015677,0.0
3197,23718,23743,25,604.6461116122335,0.8333333333333334
3198,23744,23753,9,287.8923195014368,0.3
3199,23754,23754,0,453.0703461455931,0.0
3200,23755,23755,0,185.5091263491794,0.0
3201,23756,23759,3,250.2957183067823,0.1
3202,23760,23763,3,392.7696115816226,0.1
3203,23764,23764,0,578.979261418667,0.0
3204,23765,23768,3,342.87665483730257,0.1
3205,23769,23792,23,341.3900314348827,0.7666666666666667
3206,23793,23796,3,578.8873652561041,0.1
3207,23797,23798,1,321.51311200722023,0.03333333333333333
3208,23799,23802,3,568.1807810304555,0.1
3209,23803,23806,3,454.14333048182385,0.1
3210,23807,23810,3,432.7087751075048,0.1
3211,23811,23811,0,610.1225854602012,0.0
3212,23812,23812,0,461.35274835810674,0.0
3213,23813,23816,3,516.5678007179753,0.1
3214,23817,23817,0,339.9256395589953,0.0
3215,23818,23818,0,456.240655499186,0.0
3216,23819,23822,3,300.301905027751,0.1
3217,23823,23828,5,448.48316711883507,0.16666666666666666
3218,23829,23846,17,364.4804329524563,0.5666666666666667
3219,23847,23847,0,511.3643922271251,0.0
3220,23848,23854,6,455.0936030508131,0.2
3221,23855,23861,6,550.6075509809383,0.2
3222,23862,23881,19,516.2984903880233,0.6333333333333333
3223,23882,23892,10,602.049459828125,0.3333333333333333
3224,23893,23897,4,685.7618943829449,0.13333333333333333
3225,23898,23915,17,568.0269746046847,0.5666666666666667
3226,23916,23923,7,566.1510202680084,0.23333333333333334
3227,23924,23927,3,471.45437380985595,0.1
3228,23928,23935,7,372.2714521575251,0.23333333333333334
3229,23936,23938,2,483.00161668129687,0.06666666666666667
3230,23939,23941,2,272.52504496932505,0.06666666666666667
3231,23942,23947,5,365.05046237124833,0.16666666666666666
3232,23948,23948,0,217.32824661791065,0.0
3233,23949,23952,3,438.15461503476814,0.1
3234,23953,23954,1,579.7825389723832,0.03333333333333333
3235,23955,23970,15,387.0077319466876,0.5
3236,23971,23983,12,520.2683284971475,0.4
3237,23984,23984,0,327.4040210487402,0.0
3238,23985,23985,0,507.30769869421846,0.0
3239,23986,23987,1,328.2387439036809,0.03333333333333333
3240,23988,23988,0,505.9909090655392,0.0
3241,23989,23989,0,328.3885911290914,0.0
3242,23990,23997,7,547.0379236623285,0.23333333333333334
3243,23998,24025,27,387.45520054910224,0.9
3244,24026,24026,0,72.57181765302377,0.0
3245,24027,24030,3,433.33131900481715,0.1
3246,24031,24032,1,350.00828382033217,0.03333333333333333
3247,24033,24034,1,530.4679885965032,0.03333333333333333
3248,24035,24035,0,236.23771992455386,0.0
3249,24036,24058,22,413.32629137428484,0.7333333333333333
3250,24059,24075,16,512.805865270886,0.5333333333333333
3251,24076,24093,17,352.6189308662549,0.5666666666666667
3252,24094,24098,4,395.1157487309697,0.13333333333333333
3253,24099,24099,0,222.1336472088122,0.0
3254,24100,24101,1,350.09576512058425,0.03333333333333333
3255,24102,24109,7,409.27843616382535,0.23333333333333334
3256,24110,24115,5,432.16131362372136,0.16666666666666666
3257,24116,24116,0,495.47265791026047,0.0
3258,24117,24118,1,672.6902387794588,0.03333333333333333
3259,24119,24123,4,426.3681491569835,0.13333333333333333
3260,24124,24129,5,322.9742431346882,0.16666666666666666
3261,24130,24171,41,404.13088127210955,1.3666666666666667
3262,24172,24172,0,414.12177747022474,0.0
3263,24173,24177,4,248.17501810165678,0.13333333333333333
3264,24181,24182,1,411.2749718160644,0.03333333333333333
3265,24183,24184,1,592.617064972805,0.03333333333333333
3266,24185,24186,1,466.97697715454063,0.03333333333333333
3267,24187,24204,17,397.1617273352265,0.5666666666666667
3268,24205,24206,1,253.62837047960483,0.03333333333333333
3269,24208,24216,8,413.4800380613417,0.26666666666666666
3270,24217,24217,0,242.4049680284836,0.0
3271,24218,24232,14,429.0906189154352,0.4666666666666667
3272,24233,24233,0,100.28206412104923,0.0
3273,24234,24241,7,490.19369454956853,0.23333333333333334
3274,24242,24243,1,94.53106621723673,0.03333333333333333
3275,24244,24244,0,434.08503554200826,0.0
3276,24245,24245,0,96.7527484542581,0.0
3277,24246,24247,1,331.15121946122184,0.03333333333333333
3278,24248,24248,0,108.69593926834635,0.0
3279,24249,24249,0,311.62277141902666,0.0
3280,24250,24250,0,504.02972312532097,0.0
3281,24251,24253,2,88.65356304786162,0.06666666666666667
3282,24254,24254,0,247.12773676180026,0.0
3283,24255,24262,7,99.51767173331359,0.23333333333333334
3284,24263,24265,2,334.6792215667926,0.06666666666666667
3285,24266,24269,3,248.15064903720491,0.1
3286,24270,24270,0,83.00227562499853,0.0
3287,24271,24271,0,292.8951354776712,0.0
3288,24272,24273,1,82.6593994238271,0.03333333333333333
3289,24274,24277,3,246.96059489178015,0.1
3290,24278,24286,8,479.17643883924393,0.26666666666666666
3291,24287,24288,1,282.898654453905,0.03333333333333333
3292,24289,24289,0,508.0977097639761,0.0
3293,24290,24297,7,359.2121963900761,0.23333333333333334
3294,24299,24299,0,108.84235286381377,0.0
3295,24300,24300,0,252.03056591114668,0.0
3296,24301,24301,0,499.12223845339213,0.0
3297,24302,24324,22,337.5684787956176,0.7333333333333333
3298,24325,24325,0,480.7430251961985,0.0
3299,24326,24335,9,282.1108578541677,0.3
3300,24336,24347,11,474.70663638766,0.36666666666666664
3301,24348,24348,0,344.99644259503145,0.0
3302,24349,24350,1,606.4546173187864,0.03333333333333333
3303,24351,24359,8,486.231102191212,0.26666666666666666
3304,24360,24362,2,307.2183127853985,0.06666666666666667
3305,24363,24370,7,431.78795131136576,0.23333333333333334
3306,24371,24371,0,216.42164798906788,0.0
3307,24372,24385,13,460.54181481925065,0.43333333333333335
3308,24386,24386,0,217.8432170394068,0.0
3309,24387,24387,0,478.8662660811403,0.0
3310,24388,24388,0,216.84850288531234,0.0
3311,24389,24389,0,503.5639552647816,0.0
3312,24390,24392,2,307.7431620623507,0.06666666666666667
3313,24393,24393,0,440.9407180196932,0.0
3314,24394,24396,2,314.2900327321938,0.06666666666666667
3315,24397,24399,2,447.2360216033125,0.06666666666666667
3316,24400,24424,24,325.7926784912195,0.8
3317,24425,24425,0,117.06112839947774,0.0
3318,24426,24427,1,225.6200466692708,0.03333333333333333
3319,24428,24439,11,231.35034464614077,0.36666666666666664
3320,24440,24440,0,355.97662158938044,0.0
3321,24441,24455,14,245.0681884976325,0.4666666666666667
3322,24456,24458,2,442.1723990899715,0.06666666666666667
3323,24459,24460,1,238.34463838956344,0.03333333333333333
3324,24461,24461,0,474.8948203319356,0.0
3325,24462,24463,1,298.29081486202597,0.03333333333333333
3326,24464,24464,0,435.78602661412395,0.0
3327,24465,24470,5,264.69922693920824,0.16666666666666666
3328,24471,24471,0,417.7460811346991,0.0
3329,24472,24476,4,319.8396803432958,0.13333333333333333
3330,24477,24477,0,241.61239062942684,0.0
3331,24478,24478,0,407.95507466532194,0.0
3332,24479,24479,0,240.8595446996524,0.0
3333,24480,24485,5,383.22977096362587,0.16666666666666666
3334,24486,24486,0,244.9745707707416,0.0
3335,24487,24494,7,398.57929587585187,0.23333333333333334
3336,24495,24502,7,468.63992542288236,0.23333333333333334
3337,24503,24522,19,302.78417059725535,0.6333333333333333
3338,24523,24530,7,330.3614996866211,0.23333333333333334
3339,24531,24531,0,148.19661261635062,0.0
3340,24532,24535,3,332.44741948610647,0.1
3341,24536,24539,3,579.7839515524869,0.1
3342,24541,24541,0,141.32309715288233,0.0
3343,24542,24544,2,367.75614070774583,0.06666666666666667
3344,24545,24545,0,495.3639182108053,0.0
3345,24546,24547,1,415.5870898766464,0.03333333333333333
3346,24548,24548,0,294.1254807231529,0.0
3347,24549,24551,2,487.1926107311062,0.06666666666666667
3348,24552,24565,13,305.4844950511391,0.43333333333333335
3349,24566,24569,3,371.0371007975174,0.1
3350,24570,24575,5,548.4861777144937,0.16666666666666666
3351,24576,24577,1,372.3962105171277,0.03333333333333333
